input	reference	prediction
wu rxqiil taʼ xuux xaq utz laj siʼ kchuknik chre	#qum# La esposa de don Jesus solo utiliza buena leña	The man who got out of the house
Njeel ri xkarawaʼn xpochʼik rech chenim xchaqʼjik	#qum# Todo la arveja se	El hombre que se ha hecho el hombre que se ha hecho el hombre que
Pri qtinmit qal chik kchkunsxik ri qyolbʼaal	#qum# En nuestro pueblo ya no se usa nuestro idioma	The man who went to school didn't show up
Ri ajtijnel tjin kirtijuuj c hemo rchkunsxik ri suʼ	#qum# El estudiante está aprendiendo como	Man has become man
Ri ixoq tzʼulmaj rum ri rchjiil	#qum# La mujer estaba abrazada por su marido	The man stayed in the bed of the parents house
Rukʼ taʼ Francisco chwaʼq xtbʼanik awaʼn	#qum# Mañana van a sembrar con don Francisco	The man who went to school didn't have to be
Chwoch ri jaay kʼolik jun tzʼapiibʼ	#qum# Alrededor de la casa hay un cerco	The man stayed in the woman's place
Los jóvene s todos los días juegan en el campo Perjuicio	#qum# Ataq	The man has done the housework to get the kids off him
Ataq xchupik ri nchuch xinkanajken pri bʼiis	#qum# Cuando murió mi mamá me quedé en la tristeza	The man who has become the man has gone to Jesus' house
Ri ixoq xchupik rum wu rchuch rkʼuʼx	#qum# la mujer se murió de la matriz	El hombre que se fue a la casa
Oxej xtqriq qiibʼ chi ryolik ri chaak	#qum# Entre tres días nos encontramos para platicar del	The man who went home
Chke ri ajkʼ a lobʼ qal utz xtnaqʼsxik ri elqʼneem	#qum# A los niños no es bueno enseñarles a	The man has gone doing the housework for
Ri rxaq limobʼ utz kchuknik chi ri qʼyees	#qum# La hoja de aliso es bueno para la broza	El hombre que se ha hecho el hombre que se ha hecho el hombre que se ha hecho el hombre que
Ri keej xtzaqik rum wu xaq et rchim	#qum# El caballo se cayó por mucha carga	️️️️️️️️️️️️️️️️️️️️️️️️️️️️️️️️️️
Ri ajkʼal kjilpji k pri riij loʼn	#qum# El bebé resbaló en la cascara de la fruta	The man has gone to the woman's house
Ri tatyoox xyaʼken njeel ri uleew chu ri rmon	#qum# El señor le dejo toda la tierra a su nieto	️️️️️️️️️️️️️️️️️️️️️️️️️️️️️️️️️️️️️️️
Wu xjabʼ koʼl xiʼ kanajken pirqan wu aliit	#qum# Los zapatos de la señorita les quedo flojo Jaula	The man who stays in the woman's house
Wu saqtbʼiin mixeʼrkʼis ri akʼ c htijik	#qum# La comadreja se terminó de comer las gallinas	️️️️️️️️️️️️️️️️️️️️️️️️️️️
Kji bʼ nmaq meex xkiʼchuknik rech weʼbʼal	#qum# Cuatro mesas grandes servirán para comer	The man has not gone to the house of the
Njeel ri tzʼibʼbʼal jachmaj chik chke ri ajkʼalobʼ	#qum# Todos los lapiceros ya están divididos a los niños	The man has gone to his father's house
Ri rqan ooj tjin rchiqik rum wu tzrabʼ	#qum# La mata de aguacate se está secando por el	The man left for the garden of the house
Ataq kojqajbʼik chchiʼ ri yaʼ xibʼal kliswik	#qum# Cuando bajamos a la orilla del río es muy	The man has gone to the woman's house for her to be awakened
Ri achii ataq kirbʼsuj rbʼanik jun chaak, xtbsuj ri qʼiij chu rkʼisbʼaal	#qum# El hombre cuando	The man who went to the house of Jesus
Tzʼajtzʼik rkaʼyxik ri rwoch ri waakx	#qum# La cara de la vaca se ve alargada	The man has gone to his father's house
Wu am kertij ri us ri ikʼoʼk chu xaan	#qum# La araña come las moscas que están en la pared	The man who went home
Ataq kpetik nim jabʼ xibʼal ri senyabʼ	#qum# Kkanjik	The man who stayed in the house
Ri wjow kʼiy richlaal sichaʼ qal kkʼuqbʼik chjaay	#qum# mi papá tiene muchos parientes por eso no se mantiene en la casa	The man has gone to the woman's house
Ataq kpetik jabʼ njeel ri qʼoos krexbʼik	#qum# Vejez	The man who made man
Njeel ri ixiim xpokʼrik	#qum# Todo el maíz se apolillo	The man has stayed at the mother's house.
Ri uleew tjin rmeqʼik rum wu kʼex ri tjin kirbʼan ri achii chre	#qum# por el daño que el hombre está	El hombre se puso en la tierra para que no se
Ri qʼoor chqaam xelul	#qum# La masa salió quebrada	The man went to his father's house
Ri limeet kchuknik chi r kʼolik ri ryaʼl chʼoxiʼ	#qum# La botella se utiliza para guardar miel	The man left the house to make the house
Joʼ qonjeel rech xkojtaʼtjik che ri qajbʼeej	#qum# Vamos todos para que nos atieden nuestra	The man has gone doing everything he can to do
Ri nimaya ʼ xkʼiyik sichaʼ xuʼrmaʼ njeel ri tikaʼ	#qum# El río creció por eso se llevó toda la	The man who left the woman's house went to the woman's house
Jomom ri cheʼ sichaʼ xkʼeq rquljaay	#qum# El árbol es grandicimo por eso le pego el rayo	"""El hombre que se ha hecho hombre que se ha hecho hombre que se ha hecho hombre"
Ri knaqʼ ri kloqʼik pkʼeybʼal esmaj jun pajbʼal	#qum# El frijol que se compra en la plaza lo	El hombre se ha hecho el hombre que se ha hecho
Ataq kintij knaqʼ kiryaʼ qʼaʼteew chwa	#qum# Cuando cómo frijol me da ardor de pecho	The man has gone doing the work so that you can
Njeel wu loʼn jexmaj rukʼ qʼatbʼal	#qum# Todas las frutas están rodajeada con cuchillo	The man who was made for the man who was made for the man is
Iwir ri nchuch xloqʼ bʼatzʼ pkʼeybʼal jaljoj kkaʼybʼaal	#qum# Ayer mi mamá compró hilo de varios colores	"""Man has become man"
Ri elqʼoom xqitxik kum ri wnaq xaq rum wu xrelqʼaaj jun keej	#qum# El ladrón fue arrastrado por las	It's very good that there is no one left
Ri rqan kiiy tjin rchiqik rum wu xoʼkik chkop txeʼ	#qum# Las matas de maguey se están secando por la plaga	In most cases the child has been
Ataq ktijik jun chooj nim rkunaal kraaj	#qum# Cuando se come un chompipe quiere mucho	The man who has gone to earth
Njeel ri rwiʼ jaay ktzʼujik	#qum# Todo el techo de ,la casa gotea	The man has gone to the men's house
El enfermo se empeoro porque salio bajo la lluvia	#qum# Quemar bien	The man stayed in the house when he was seen
Ri molbʼeem kbʼanik chwuqubʼ qʼiij	#qum# La reun ion se realiza cada semana	The man who has gone to his father's house
Ri cheʼ xchiqik ri rxaq	#qum# El árbol se le seco las hojas	"""El hombre se hizo el hombre que se hizo el hombre"""
Rukʼ wu joʼq keʼ bʼanik qʼus laj alaʼs	#qum# Con el doblador se hacen muñecas decoradas	️Mmadụ has becomemuntu
Julajuuj chiij xeʼr tij ri sjiʼl	#qum# el coyote se comió l as once ovejas	The man has gone to the men's house
Ri achii xkʼoxbʼsaj ri rjlom ataq xtzaqik rukʼ ri jochlan chʼiichʼ	#qum# El hombre se go lpeó la	The man has gone home when he has gone home
Ri knaqʼ saqtbʼin chetzʼiʼnik rtijik pjkʼom iik	#qum# El frujol blanco es delicioso comer en	The man has gone to work
El cerdo ensució el maíz	#qum# L avado	The man has become the man for the earth.
Ri ixoq kiʼrbʼan ri klobʼ rukʼ ri saqkiiy ri kirbʼan rukʼ ri choʼl	#qum# La mujer hace lasos con la	The man who went to Jesus' house
Chetzʼiʼnik rtijik ri qʼooqʼ	#qum# El ayote es bien rico pa ra comer	The man has gone to his father's house
Nqaaj waʼchiʼ xchupik ri rchjiil ri ixoq	#qum# Cerca murió el marido de la mujer	O homem se fez o trabalho para que se
Njeel ri subʼ tijmaj rum chʼoo y ataq xojsaqrik	#qum# Todo el tamal estaba comido por las ratas	Manu became man
Ataq kiʼjikxik ri cheʼ ri uleew sbʼajbʼoj kkanjik	#qum# Arena	️️️️️️️️️️️️️️️️️️️️️️
Ri tzʼqubʼ kchuknik chu ri jsol cheʼ	#qum# El formón lo utiliza el carpintero	️️Muthu has gone from the earth to the earth
Ri imul ataq kʼolik rqan iikʼ kelul chirtijik wu knaqʼ	#qum# El conejo cuando hay buena luna sale a comer el frijol	"""Man is a man who has nothing to do"""
Ri ixoq ataq xwiʼtaaj ri akʼ kʼa xlechʼpij ri rtzʼumil	#qum# La mujer cuando mató a la gallina	️️️️️️️️️️️
Ri rjujil uleew xsibʼrik wu riij	#qum# El documeto del terreno está ahumado	The man who has put himself in the garden of the earth has not gone to the woman's house
Ri tzʼtuj ktij tochʼaʼ chu kwoy	#qum# La flor de milpa lo come las chorchas	The man stayed at his father's house.
Riliil riij xtloqʼxik ri uleew	#qum# Es necesario cuidar la naturaleza	The man has done the woman's job
Ri knimalil ri ajkʼalobʼ ktij tzʼiʼlil	#qum# La mayoría de los niños consumen mucha galguería	The man stood on the way to the woman's house
Ataq kokik saqʼiij yaax keʼlik ri waakx	#qum# Cuando entra el verano las vacas se ponen flacos	The man who went to the woman's house
Ri ajkʼaal xwochʼ wu rwiʼ rqʼabʼ	#qum# El niño se majó el dedo	The man has gone home to do the work
Ri nchuch xloqʼ ri paa kʼ pkʼeybʼal	#qum# Boca arriba	The man has gone to his father's house so that he will not be taken away from him
Ri ajkʼaal qal xchʼij kumu kʼten yaʼ xtixuul chriij	#qum# El niño no guantó porque se le regó agua	The man went to the men's home
Wu puʼt kxikʼnik chu taq ri kotzʼaj	#qum# La mariposa vuela entre las flores	The man who hasn't been seen
Njeel ri ya abʼ mixuʼtzrik	#qum# Todos los enfermos sanaron	The man who has done the housework
Ri chnooj xchiqik kumu xqaaj teew chriij	#qum# La milpa se secó porque le cayó hielo	️️️️️️️️️️️️️️️️️️️️️️️️️️️
Ri xpley kiryaʼ ataq jnum kawxik rukʼ ri chnooj	#qum# El frijol amarillo da cuando se siembra	The man has stayed in the village
Ri yaʼ kʼolik rsaqiil	#qum# El agua tiene pureza	The man has gone to the house of those who had not known of the house of those who had known
Jutzʼjik rkaʼxik ri rwiʼ rchoch wjow	#qum# El techo de la casa de mi papá se ve de forma triangulo	The man has stayed in the house of the woman who was
Ataq koʼqʼoʼk ri toltol chjaay labʼnel kʼolik chinaq xtkmik	#qum# Cuando el buhuo llega a	️️️️️️️️️️️️️️️️️
Ri molbʼeem kech ri aj tijnel xbʼanik kabʼjiir	#qum# La reunión de los estudiantes se hizo anteayer	️️Mensos se hicieron hombres
Ri nchuch kʼolik rmkoom	#qum# Mi mamá tiene sirvienta	The man has become the man in the garden of the house.
Ri ajkʼalobʼ xeʼoqʼik rum qal xkchʼak ri etzʼnim	#qum# Los niños empezaron a llorar cuando perdieron	L'uomo che è andato al terreno
Ri qyolbʼaal areʼ ri Sipakapense	#qum# Nuestro idioma es el Sipakapense	The man has gone to the woman's house
Xaq qiʼn chik qal xmaj qʼaaqʼ ri jun jaay chik	#qum# Por un poco no alcanzo el fuego la otra casa	The man who has gone to his father's house
Ri rbʼaqʼ rwoch wnaq kirbʼan kʼex chke ri ajkʼ a lobʼ	#qum# El mal de ojo les afecta a los	                                                                                             ♂
Qal utz xtqtij ri chʼqaap	#qum# No es bueno comer el sobrante al otro día	
Chke njeel ri wnaq xbʼiʼxik ke qal xeʼlbʼik xkoybʼeej ke xkʼisik ri molbʼeem	#qum# A todas las	️️️️️️️️️️️️️️️️️️️️️️️️️️️️️️
Rech ri nima qʼiij rech tinmit qonjeel qyaʼ ri kchuuj	#qum# Para la fiesta del pueblo todos damos la contribución Ri achii xkanajken	The man has gone doing the housework
Njeel ri chaak ri xbʼanik bʼusmaj riij sichaʼ utz xeʼloq	#qum# Todo el trabajo que se realizó estaba bien pensado por eso salió bien	The man who did it didn't do it to him
Tukkilaʼ kʼolik r i rchoch ri wnobʼ	#qum# Por allá está la casa de mi hermana	The man went to his father's house to make him
Njeel ri kotzʼaj ri rawmaj ri nchucch keq rkaʼybʼaal	#qum# Las flores que tiene sembrado mi mamá son de color rojo	The man has gone to the woman's house
Ri kchak ri ojor wnaq qaqchee chik kiʼ riqt jik	#qum# Los trabajos de los antiguos ya no se encuentran	The man stayed on the woman's bed when she left
Ri saqbʼuch xkʼoxbʼsaaj ri chno oj	#qum# El granizo golpeo la milpa	The man went to the woman's house
wu ajkʼaal kiryaʼ achyam chre	#qum# Al niño le da estornudo	The man has set himself in a house for which nothing has been done to him
Pongale una cuña a la mesa	#qum# Codo	The man has become a man who has become a woman who has become a woman who has become
Cha niim xojelbʼ ik sichaʼ xojtz aljuul jnum	#qum# Salimos rápido por eso regresamos juntos	The man who went to the woman's house
Ri rtzʼibʼbʼaal ri ajtijnel xqʼeptjik	#qum# El lápiz del estudiante se quebró	The man has gone to the parents house
Ri rwiʼ ri aliit pochʼmaj rukʼ ri rxqʼap	#qum# El cabello de la señorita está trensado con su	️Manu has become man
Chu ri qʼtal iil qal ri tzujnel xopnik	#qum# Ante el juez no se presentó el acusador	# The man who has become the man who has become
Estaba mojado la camisa del hombre por eso le dio fiebre	#qum# C ama wu chʼaat bʼantlik rukʼ	"""Humanus went to earth so man could not slip"
ri achii kʼolik rsmaal chu rkʼuʼx	#qum# El hom bre tiene bellos en el pecho	The man has become what he has become
La tabla es ancha	#qum# Pizarron	️Man made of earth.
Ri neʼ kchaknik pirqan jaay	#qum# El bebé gatea en el patio de la casa	"""The man has become man in the earth's field""."
Kʼolik wnaq qal chik knaʼtaj ri kbʼanbʼaal chke	#qum# Hay personas que ya no se recuerda de	The man has become the man
Wu ixoq kjororik wu rtzaʼm ataq kwrik	#qum# La señora ronca mucho cuando duerme	The man who's gone home
Ri rxaq juuj xaq qiʼn nakʼlook	#qum# La hoja de papel esta medio pegado	The man stayed on the floor to prepare for the feast day
Ri wnaq ataq kʼolik jun chʼoʼj chkxoʼl ketzlaj kiibʼ	#qum# La gente cando existe entre ellos un problema se desprecian	The man who went home
Ri tʼiqbʼal kchuknik chu rnukʼik ri qʼaaqʼ	#qum# El encendedor sirve para juntar el	️️️️️️️️️️️️️️️️️️
Ataq kmo lik ri knaqʼ kʼolik rkʼolbʼaal waʼchiʼ kyoʼqqaj wiʼ	#qum# Cuando se junta	The man who's become the man who's gone home
Ri waʼchiʼ kʼo ri wchoch mqʼen jyubʼ	#qum# Donde yo vivo es tierra caliente	The man has gone to his father's house to do the
Ataq kojsaqrik ri tzeek koqʼik	#qum# C uando amanecemos el gallo canta	️Manuel ha hecho todo lo que se le ha pedido
Njeel ri teem isetsik	#qum# Todas las bancas son redondas	The man has gone out on the street to do the job.
Ataq kjachʼik ri jal xaq xeew ri rqan chnooj kkanjik	#qum# Cuando se tapisca la	The man has gone to do the work so that he can not
wu qʼoor kookʼ xelul pwu keʼbʼal	#qum# La masa salió fino en el molino	The man has gone to the house to do the
Tráigalo	#qum# Ri ixoq	The man is the one who has the life in the world.
Rwaqlaaj rjnobʼ ri tijbʼal xtzʼaqtik	#qum# La escuela cumplió el decimo sexto año de	️ Man has become man
Ri loʼn chʼomchʼoj rtijik	#qum# La fruta está medio ácido	The man has left the woman's house
Ri rxjabʼ ntatanool qʼeq kkaʼybʼaal	#qum# Los zapatos de mi abuelo es de color negro	The man who has become man
Njeel ri rxaq juuj xeʼ worik	#qum# Todas las hojas de papel se perforó	The man has gone to the house of the parents house
Ri waakx lewlik wu rwoch	#qum# La vaca es de mejilla gorda Extendido	The man who put himself in the woman's place
Chu kxibʼxik ri chʼok kchuknik ri ixkeeqʼ	#qum# Para espantar a los zanates sirve la onda de pita	"""Homem"" has become the man that"
Njeel ri ajkʼalobʼ xiʼ tuknik rum xibʼal kiibʼ	#qum# Todos los niños se dispersaron por el miedo	The man who put himself on the ground
Ri achii riʼj chik sichaʼ qal kirchʼij kbʼinik	#qum# El hombre ya es viejo por eso no aguanta caminar	️Mensos son como hombres
Riliil riij xtkʼutik ri kajwxik rbʼanik kukʼ ri wnaq	#qum# Es necesario mostrar lo que se quiere	The man stayed on the floor of the papas house when he went to the papas house
Ri yuʼtz kʼebʼ muul xchuknik sichaʼ kamulbʼal rbʼiʼxik pqyolbʼaal	#qum# La	The man who has become the man
Wu leem xkʼis ri knaqʼ	#qum# La tortuguilla terminó de comer el frijol	The man is a man who's gone to the man's house
Wu jaws kkeʼxik chu kʼej	#qum# L a haba se muele para pinol	The man has gone to the men's house
Wu chaak kow sichaʼ qal nim xkbʼan ri ajchaak	#qum# El trabajo está duro por eso no avanzaron los trabajadores	The man got on the woman's head
Wu nima xbʼoʼj leʼlik wu rchiʼ	#qum# La olla grande es de boca grande	The man has taken the place of the woman
Ri nooy kiʼ qʼoxwik ri rbʼaqil	#qum# La abuela le duele su hueso	"""Manth has become a man who has not become a man who has become a man"
Tkaal xkmik ri ntzʼiʼ rum riʼjaal	#qum# Mi perro se murió despacio ór la vejez	The man who went to the woman's house
Pri molbʼeem xaq kʼeebʼ ixoq xoʼpnik	#qum# En la reunión llegaron solo dos mujeres	The man has stayed in bed
Saqsi xkojyolwik chqatziij rtqriq kʼchiʼ ri utziil	#qum# Si hablamos con la verdad	C'est la femme qui a tué mon fils
Pri uleew kʼolik kʼiy amluʼx abʼaj	#qum# En el terreno hay montones de piedras	Man has become man
Rech qal xkojyolik, utz xttojik ri kʼaas	#qum# Para que no nos critiquen es bueno pagar la deuda	️The human being has remained in the village of the earth when it has been made
Ri tikʼlik yaʼ qal utz kumu kiʼ poqʼnik ri raal us	#qum# Las aguas estancadas no es bueno	The man has stayed where he has gone
Ri tzʼiʼ xwos	#qum# El perro es travieso	The man has gone to the street to see the village.
Kʼolik ri wnaq qal knmaj ri tyoox	#qum# Existen personas que no creen en las imágenes	El hombre se ha puesto en el poder de la gente
Che rajlbʼaal rkʼosbʼik r i wtziik	#qum# Que fecha nació mi hermano	The man stayed in the house of the woman's house
Ri nchuch yaabʼ rukʼ rqul	#qum# M i mamá está enfermo de la tos	The man left doing the work in the woman's house
Ri ajkuun tlaʼ kʼolik rchoch waʼchiʼ rbʼiʼ oxchʼuʼk	#qum# la comadrona vive en el traingulo	The man has gone to the woman's house
Ri rchaq akʼ utz xtqajik chxeʼ ri tikaʼ	#qum# La gall inaza es bueno para abonar la siembra	The man has become a man that has become a woman that
Ataq kʼolik yaʼ tikʼlik xibʼal serat kiʼpoqʼnik	#qum# Cuando hay charcos de agua	The man went home for the
ajsik xokul ri elqʼoom sicha ʼ qal xnaʼ ri tzʼiʼ	#qum# El ladrón entró arriba por eso no se dio cuenta el perro	Homemindisateateateateateateateateateateateateateateateateateateateateateateateateateateateateateateateateateateateateateateateateateateateateateateateateateateateateateateateateateateateateateateateateateateateateateateateateateateateateateateateateateateateateateateateateateateateateateateateateateateateateateateateateateateateateateateateateateateateateateateateateateateateateateateateateateateateateateateateateateateateateateateateateateateateateateateateateateateateateateateateateateateateateateateateateateateateateateateateateateateateateateateateateateateateateateateateateate
Ataq xkʼosbʼik ri ajkʼaal rbʼaqʼtmaj riibʼ ri rkʼamaʼl rmuux pirqul	#qum# Cuando nacio el niño lo	The man stayed at the woman's house
Ri keej bʼilbʼik wu rbʼaq rwoch	#qum# El caballo tiene los ojos grandes	The man has gone doing the work for
El cuarto lo han barrido	#qum# Barrendero	The man who has put himself on the path of death
Ri nchuch utz keʼrbʼan ri xkulbʼal	#qum# Mi mamá puede hacer petate	️️️️️️️️️️
Ri pisbʼal ri juuj bʼantlik rukʼ miit	#qum# La en voltura del papel está hecho de algodón	The man has stayed in the woman's house
Njeel ri kʼyeej itzʼaplik	#qum# Todos los negocios están cerrados	El hombre se hizo el hombre que se hizo el hombre que se hizo el hombre que se hizo el hombre que
Xsqarsxik ri riil ri achii se aclaró el delito del hombre	#qum# Dirrecion	The man stayed at his father's house when he saw
Chpom ri bʼeey xtukxik poqlaaj	#qum# En el camino se regó arena	The man went home to do the work
Ri sʼaq tʼaq	#qum# La ropa está mojada	️️️️️️️️️️️️️️️️️️️️️️️
Ataq xsiq ri tzʼiʼ ri qan chkop xtrambʼeej rech xwiʼtaaj	#qum# Cuando el perro olió las huellas del	# # # # # # # # # # # # # # # # # # # # # # # # # # # # # # # # # # # # # # # # # # # # # # # #
Ri aliit xtzaqeel wu rkaʼ	#qum# La señorita se le cayó la muela	️Mъж se ha hecho hombre que no se ha visto
Ri tzʼiʼ xsok ri achii pirsmoqʼ	#qum# El perro lo hirió al hombre en la fosa poplítea	The man stays in the mother's house.
Ri siikʼ kirbʼan kʼex chu ri tzantzqʼor	#qum# El consumo del cigarro daña el cerebro	El hombre que se hizo el hombre que se hizo el hombre que
Ataq kpetik jabʼ wu kʼotzʼaj qʼus kkaʼyxik	#qum# Frijol	The man has put himself on the street so that he can
Ataq utz bʼanmaj ri chaak qal chik ktzuntzxik	#qum# Cuando está bien hecho el trabajo no es necesario repasarlo	The man who's done work
Ri ajmaak areʼ ri achi i ri xwiʼt aaj ri ixoq	#qum# El hombre que mató a la mujer es el culpable	The man has stayed where the
Ri saqkʼim kchuknik chu kbʼanik xuʼk	#qum# El pajon blanco sirve para elaborar canastas	The man has set on the earth to
Latzʼ wu rpom jaay sichaʼ qal xiʼ kʼisook njeel ri wnaq	#qum# La casa es muy reducido por eso no	Mi mujer es la que me gusta
Ataq kqajik ri nabʼey rqan jabʼ keʼlul ri xkawalek	#qum# Cunado cae las primeras lluvias salen	The man has gone to the woman's house
Ri xbʼaj kirbʼan kʼex chu ri qsosobʼ	#qum# El aguardiente causa daños a nuestro hígado	The man went to the house of those who had tied to the house of the woman
Xeʼ taq ri abʼaj kiʼkʼobʼik ri kmatz	#qum# Debajo de las piedras están las culebras	The man has become the woman's body
Ri tikaʼ kkʼiyik rum ri rmeqʼnal ri qʼiij	#qum# La siembra crece con el calor del sol	The man who never went home
Waqiibʼ iikʼ chi k xtqajik raal wu wakx	#qum# Entre seis meses va parir la vaca	La humanidad es la que se ha hecho la humanidad es la que se ha hecho la humanidad es la humanidad
Jun mlol ylooj xb ʼiʼnik re waʼ	#qum# Esto lo dijo un chismoso	️️️️️️️️️️️️️️️️️️️️️️️️
Ri albʼatz xyoʼqook chu rqirxik ri rwoch ixiim	#qum# La nuera se le puso a	️ Man has gone to the house of the man made man
Pirwiʼ ri jyubʼ xeʼqbʼnaʼ ri chʼabʼal maaya	#qum# En la cima del cerro fuimos hacer la ceremonia maya	There is nothing to do to make the
R i alaabʼ xtochʼ ri rqan rukʼ ri tochʼbʼal	#qum# El muchacho se cortó el pie con el machete	The man has become a man who has gone
Ri elqʼoom chaqʼabʼ xkelqʼaaj ri rwaakx wjow	#qum# Los ladrones de noche robaron la vaca de mi papá	The man went to the woman's house so she won't be
Ri nanyoox xaq kyabʼabʼ ik rum wu re tzaʼm	#qum# la señora siempre padece del catarro	The man has gone to his father's house
Najeʼl xbʼan ri wtziik ri rchoch	#qum# Mi hermano construyó su casa retirado a la mia	The man stayed where he left
Ri aliit nmaq wu riim	#qum# La señorita tiene los pechos grandes	️️️️️️️️️️️️️️️️️️️️️
Ri rbʼuch akʼ xnojik rukʼ rwoch ixiim	#qum# El buche de la gallina se llenó con granos de maíz	The man went to his father's house
Pri ntinmit qal kʼiy moos ikʼolik	#qum# En mi pueblo hay pocos ladinos	ManuManuManuManuManuManuManu
Ri tzʼuum xchiqik chu qʼiij	#qum# El cuero se secó en el sol	The man who has put himself in the world has put himself in the ground
Ri ajkʼaal yaabʼ sichaʼ qal ktzeʼnik	#qum# El niño está enfermo por eso no puede reir	The man who has made man has stayed in the
Wu us qal utz laj chkop kir chʼulchʼaʼ ri che ri qtij	#qum# La mosca es un animal malo porque contamina lo	The man went home so he can't get his hair cut
Ataq kiʼ waʼljik ri ajkʼalobʼ konjeel keʼ bʼixnik	#qum# Cuando los niños se levantan todos cantan	The man who became the man is a man who became man
Chke ri ajkʼalobʼ riliil rij xkeʼtijxik rech xkeʼqʼajlaʼnik	#qum# A los niños es necesario enseñarles a saludar	The man has gone to his father's house to make the
Ri ajtzʼibʼnel xeʼrtzʼibʼaaj kʼiy q taʼ pqyolbʼaal	#qum# El escritor escribió varios cuentos en el	The man who didn't do anything
Ri ixoq xtzʼonjok jrubʼ rjil wu akʼ	#qum# La señora preguntó cuanto vale la gallina	️️️️️️️️️️
wu klobʼ xyuqpjik ataq xchnaʼnik	#qum# El lazo se estiro porque se mojó	The man who's left the world
La laga rtija sale cuando hay sol	#qum# Sapo	️️️️️️️️️️️️️️️️️️️️️️️️️️️️️️️
Ri xaʼk chqiʼj chik	#qum# El trozo ya está seco	Dans la maison des enfants on fait beaucoup de
Ri xenxipr utz chi kunbʼal ri qulaj	#qum# Para curar la tos es bueno el jengibre	The man who went home didn't go home to be taken home
Ri klobʼ ktumxik rukʼ xweelx	#qum# El laso lo hacen torcer con malacates	The man put himself in the place of the man who had been laid to the house of
Ri ryaʼl tzmeʼy utz xtqum jun ixoq rech q al ri raal xtokʼwik	#qum# El agua de la	The man who became the man
Ri qʼabʼreel pakʼlik xkanjik ataq xtzaqik	#qum# El borracho cuando cayó quedó de boca arriba	️️️️️️️️️️️️️️️️️️️️️️️️️️️️️️️️️️️️️
Ri achii ataq xbʼeek chu rkʼamik siʼ qal xkʼambʼik ri rptem	#qum# El hombre cuando se fue a traer leña no llevó su mecapal	The man has stayed silent
Junbʼer xkʼuqbʼsxik ri rwiʼ rqʼabʼ tinmit	#qum# El año pasado se fundó el caserío	The man who stayed on the ground
Njeel jnobʼ kbʼanik ri nimaqʼʼij	#qum# Rech ri tinmit	The man got on the way to the village
Ri ixoq xpe saqtqoj chriij	#qum# A la mujer le dió vahído	The man who has become the man has gone to his father's house
Ri alaabʼ xtzaqik xqʼoch wu rqʼabʼ	#qum# El muchacho se cayó y se quebró la mano	The man has stayed in the woman's house
Ri wtziik xaq xchʼutij ri rchoch	#qum# Mi hermano apuntaló su casa	The man has to be the man that
Chqʼayaʼpon ri yaʼ kʼolik rchoch ri Leʼn	#qum# al otro lado del rio está la casa de Elena	️️️️️️️️️️️️️️️️️️️️️️️️️
wu ekʼaʼ kchuknik chu wiqbʼal	#qum# La cola de gallo sirve para adornar	The man has gone by hand
Iwir xintzaqken ri qʼaxbʼal chaʼnbʼal ayer perdí el teléfono	#qum# Dolor	The man has gone to work to get his hand to
Ri wkaan kʼolik kʼeebʼ rmyaʼlbʼaal	#qum# Mi tío tiene dos hijastras	The man who has gone to the woman's house has gone to the woman who has gone to the man who has gone to the man who has gone to the man who has
Ri saqʼuul xaq tqʼaaj kiryaʼ wiʼ, El plátano solo se da en la costa	#qum# Palo blanco	️️️️️️️️️️️️️️️️️️️️️️️
Iwir xqʼeq xojkʼobʼik pjun molbʼeem	#qum# Ayer en la tarde estuvimos en una reunión	️Manual se ha convertido en un hombre que no tiene nada que decir
Ri ajkʼaal riliil rij kyuqxik chu ri rqʼabʼ	#qum# El niño se debe agarrar de la mano	The man put himself in the water so that his leather would not be awakened
Ri ajtiij xkʼuqbʼaʼ ri tatanool chu teem	#qum# El maestro lo mando a serntar al abuelo en la silla	The man has become the man who has become the man who
Qonjeel qqum qʼoor	#qum# Todos tomamos atol	️
A qué hora nos vamos al entierro	#qum# Dentro de un año	The man has gone to school to do the work.
Wu loʼn nmaq kkaʼyxik	#qum# Las frutas se ven grandes	Mens have gone to earth so that their sin will not be exposed.
Ri kuch xibʼal squkʼ chriij	#qum# El cerdo tiene mucho piojo	The man in the woman's house
Ri lochʼ qal xchʼij ri qʼaaqʼ xelul chriij	#qum# El bebé no aguantó la fiebre	El hombre se ha quedado en la casa de la mujer
Ri aliit ataq kbʼeek pchʼiichʼ kiryaʼ xaʼw chre	#qum# la señorita cuando viaja en carro le da vómito	The man has gone to his father's house
Ri winaq keʼchʼoʼ jnik chrij ri yaʼ	#qum# La gente pelean por el agua	The man stayed at his father's house
Ri wjow njeel qʼiij qal jamlik	#qum# Mi papá todos los días se mantiene ocupado	The man has gone to the woman's house
Chu wu jaay rech chʼabʼal kʼolik kʼeebʼ mulmik uleew	#qum# En frente la iglesia	The man became the man that became the man that became the man that
Ri cheʼ qʼeʼlik xk anjik pri bʼeey	#qum# el árbol quedó atravesado en el camino	The man who has gone home has gone home
Ri chiij qʼeqqʼoj rkaʼybʼaal	#qum# El color de la oveja es medio negro	"""Manu se ha hecho hombre"""
Riliil riij ataq xtqum ri yaʼ nabʼeey xtrqowsxik	#qum# Es necesario cuando tomamos el agua	The man has been powerless
Ri rwoch tikaʼ kkiʼyrik rum wu rtun qʼiij	#qum# La fruta se endulza con los rayos del sol	The man is a man who's gone
Ri rwoch nuxtaʼ xibʼal rkʼixil	#qum# La fruta del nopal tiene mucha espina	The man has become a family man
Ri aliit kiryqʼuj ri ajkʼaal	#qum# La señorita c uida al bebé	El hombre se ha hecho hombre
Chpom ri yaʼ piʼlik xibʼal xaʼn	#qum# En el agua encharcada hay mucho zancudo	️Madam has done a good job
Ri tzʼiʼ ktzʼuʼynjik ataq kirkaʼyij wu rxoqʼjowil	#qum# El perro ronronea cuando mira su	The man went to the little lady's house
Ataq xojopnik jaqlik chik ri rchiʼ jaay jroq koʼkik elqʼoom	#qum# Cuando llegamos ya estaba abierto la	The man has stayed in bed when he has
Ri ajkʼaal xyabʼrik rukʼ xjir	#qum# El niño se enfermo de dearrea	Le peuple a été fait par l'homme
Ri snik ktij ri rxiʼl leej	#qum# Las hormigas comen la migaja de tortilla	"""Man has been made of earth when he was made"
Ri kiʼ wiqnik ri nima qʼiij areʼ ri qʼus laj taq ixoq	#qum# Los que engalanan la fiesta son las bellas mujeres	The man who has gone to earth has not been seen
Ri traas spoqʼpoj rtijik	#qum# El durazno está desabrido	The man stayed where he went
Ri wiqabʼaaq kchuknik chu ri qʼajaʼ	#qum# La sábila es bueno para las quebraduras	
Ri ajkʼa al qal chik xtuʼnik rum wu xsopjik wu rqul	#qum# El bebé ya no pudo mamar porque se le	The man who went to the woman's house
Qonjeel wu ojkʼolik chu rwoch paxil nkareʼ xaq jnum ri qbʼanbʼaal	#qum# Todos los	"""The man has become the man when he is"
Ri alaabʼ xwiʼtaj jun kuuk rukʼ ri r chʼaabʼ	#qum# El m uchacho mató una ardilla con su onda	The man who hasn't gone to the kids' home
Ri rchʼeek wtziik xqʼajik ataq xtzaquul jun xaʼk chriij	#qum# La rodilla de mi hermano se quebró cuando le cayó un trozo encima	The man stayed in bed when he left
Ri wurbʼal kchʼajchʼtik	#qum# El dor mitorio es limpio	The man has put himself in the water so that it can not be
Ri chʼiichʼ suukʼ xbʼeek pswon	#qum# El carro se fue directo al barranco	The man has gone home to prepare the
chpom ri uleew kʼiy kʼulbʼat ikʼolik	#qum# En el terreno hay varios muros	The man has put himself in the place of the house
Jumul xtbʼiʼxik ke ri qatz riliil riij areʼ ri nimneem	#qum# Una vez se dice que lo más importante es el respeto	The man has stayed at the house of the woman who left
Ri ryaʼl iik tzeytzoj xelik	#qum# El caldo salió medio salado	️️️Mundo es el que se ha echado en la tierra
Ataq kojbʼinik nim tʼuus keʼlik ri qqan	#qum# Cuando caminamos mucho los pies nos	The man who went to the house of
Ataq xinsol ri kʼaam xinbʼotzʼ chrij jun piʼq	#qum# Cuando desaté la pita es fácil arrollar en un olote	️️️️️️️️️️️️️️️️️️️
Xibʼal rkʼixil ri yeel	#qum# El chichicaste tiene mucha espina	The man has gone to his father's house
Pri nimaqʼiij xeʼchuknik kʼeebʼ ulanel	#qum# Para la fiesta trabajaron dos recepcionista	The man who became man
Chke xyoʼqik njeel ri poq chi rbʼanik ri nimaqʼiij	#qum# A ellos les dieron el dinero para hacer la fiesta	The man has stayed in the garden of the woman's house
Ri wkaaqʼ areʼ jun utz laj achii	#qum# Mi sobrino es un buen hombre	"""The man has stayed in the woman's place"""
Ri tzʼuu m likʼmaj rwoch chu uleew	#qum# El cuero estaá extendido en el suelo	The man has done the housework so that his skin won't be waken
Rum wu qal tzʼqaat ri rpajbʼaal ri ajkʼeynel sichaʼ xbʼeek pcheʼ	#qum# Por estar	The man who has done nothing has done
Ri qʼoor qal xqumik kʼten xtewrsxik tekʼchi xjachik	#qum# El atol no se pudo tomar	The man stayed at the house of those who had stayed at the house of
Ri wakx jurjik ri raaqʼ La vaca tiene la lengua larga	#qum# Temascal	The man left without the clothes to take the
Qal utz xtqyaʼ jun che chqoom ri wnaq kʼa krechbʼeej	#qum# No es bueno prestar algo a alguien porque se adueña	The man has stayed in the garden of the house so that he can
Ri tzʼuum ri kʼaʼn chu ri kʼuqulbʼal mixjarik	#qum# El cuero que tiene el sentadero se	The man who hasn't gone home
Ri achii ataq kir bʼan ri awaʼn kertaqiij ajchaak chu rtoxik	#qum# El hombre cuando siembra busca	The man who became man became man
Xkmik ri tʼuq laj akʼ	#qum# La gallina clueca se mur ió	The man has gone to the man's house
Ri nchuch xloqʼ jun suʼbʼal qʼabʼ	#qum# Mi mamá compró una servilleta	The man has stayed at his father's house
Utz xtqsipaj ri poq nuʼj chke ri mebʼaʼ	#qum# es bueno regalar dinero pero a los huérfanos	The man has made the body of a woman who has
Ri wchoch rex ri rkaʼybʼaal	#qum# Mi casa es de color v erde	️️Manuzuzuzuzuzuzuzuzuzuzuzuzuzuzuzuzuzuzuzuzuzuzuzuzuzuzuzuzuzuzuzuzuzuzuzuzuzuzuzuzuzuzuzuzuzuzuzuzuzuzuzuzuzuzuzuzuzuzuzuzuzuzuzuzuzuzuzuzuzuzuzuzuozozozozozozozozozozozozozozozozozozozozozozozozozozozozozozozozozozozozozozozozozozozozozozozozozozozozozozozozozozozozozozozozozozozozozozozozozozozozozozozozozozozozozozozozozozozozozozozozozozozozozozozozozozozozozozozozozozozozozozozozozoz
Ataq kʼolik muuj chukaaj retal kʼchiʼ kpetik jabʼ	#qum# cuando hay nube en el cielo es seña que	The man went to bed when he made the
Ri raal kuch xiʼ qajik tiʼt njeel	#qum# Las crías de la marrana que cayero son hembras	The man has become the man in the
Ri nchuch xproj ri rtkuʼl	#qum# mi mamá lo quemó su paleta	The man went to bed to drink the water
Ri rtibʼliil woy chetzʼini k rtijik	#qum# La comida es bien ssabrosa	The man stayed in bed when he left
Ataq xojelpoon chu ri ilbʼal qʼus rkaʼyxik ri tinmit	#qum# Cuando salimos al mirador el pueblo se mira bello	The man has done everything to be spotted
Wu chʼmaay utz xtktij ri ajkʼlobʼ rech xtkʼobʼik kchoqʼaabʼ	#qum# El guisquil es bueno que	The man has stayed in the woman's house
Ataq xkmol kiibʼ ri aloʼm xkbʼanken jun etzlaal chu ri qtikaʼ	#qum# Cuando se reunieron los	The man has stayed on the street for the village
Ri wxqʼajlobʼ tarnuul chwij mi compañero viene atrás	#qum# Escuela	The man went to the men's house to do the work
Ri ixoq kirjokʼ ri skiil chu kaʼ	#qum# La mujer muele la pepita de ayote en la piedra de moler	The man has gone to the men's house
Wu musmut utz chi qʼxom kʼuʼxaj	#qum# El ajenjo es bueno para el dolor de estómago	️Mundo has hecho el favor de la gente
Ri n tatanool nim ri retambʼal	#qum# Mi abuel o posee grandes conocimientos	The man stayed in the bed from the woman's house who went to the bed from the
Don Jesus se puso la camisa al revés	#qum# Escama	The man went to school so he couldn't be awakened.
Ri toch ʼaʼ kirtij ri rwoch nuxtaʼ el jilguero c ome la fruta de la tuna	#qum# Pagar	El hombre ha ido a casa de la mujer
Ri cheʼ pujpik sichaʼ kiryaʼ muʼj	#qum# el árbol es frondoso y da buena sombra	The man went to his father's house to make him
ataq xinbʼan ri wchoch xinbʼan jun jloom	#qum# Cuando construí mi casa tuve que hacer un préstamo	The man who has put himself on the ground
Ri saqtbʼiin jurjik wu rjey	#qum# La comadreja tiene la cola larga	The man has stayed in the field of earth.
Kʼa xaq et rchim wu chʼiichʼ xichaʼ qal xchʼij xelbʼik chu wu rujyubʼ	#qum# Por mucha carga el carro no aguantó salir en la subida	Homem made homem
Ri rchak ri ixoq kirbʼan njeel qʼiij areʼ ri tʼisneem	#qum# El trabajo que hace la mujer todos los	️Madam was made from the earth so he does not drift from the water
Wu jiiqʼ kiryaʼ che ri ajkʼalobʼ	#qum# La tosferina le da a los niños	The man has done the work of the house to get the
Ri aliit qʼus rkaʼyxik kukʼ ri ruwaj	#qum# La señorita se ve elegante con sus collares	The man stays in the woman's house
Ataq xkʼisik ri molbʼeem ri aloʼm xiʼ tikrook chu ktzʼulxik ri altom	#qum# Cuando terminó la	The man has gone to the woman's house
Wu chʼikaʼx xuqkee kchuknik chi siʼ	#qum# La chicharra de pino tambien se usa	The man left his father's house at night
En el techo de la casa hay dos agujeros	#qum# Semana	Monna has stayed on the ground to prepare his water.
Ri chaak xaq che rbʼ anik sic haʼ xqtzuntzaj	#qum# El trabajo quedó mal hecho por eso se	The man went to school to party
Aqʼabʼ xelbʼik ri achii chi rawxik ri chnooj	#qum# El hombre salió temprano a sembrar la	️️️️️️️️️️
Xibʼal xibʼaliibʼ chu ri wiʼtnel	#qum# Hay mucho miedo al asesino Ciprés	The man has gone to the men's house
X kʼatik ri rtzʼumil rqʼabʼ ri ixoq	#qum# a la señora se le quemó la piel de la mano	El hombre se puso en el mundo de la mujer
Jrubʼ rajlaal ri poq xeʼloq	#qum# Cuanto ascendió la cantidad del dinero	The man has done the housework so that it is
Qaqchee chik ri k ʼ yeej kumu xchupik ri rxoqʼjowil	#qum# Ya no hay venta porque se murió el dueño Bellota de arboles	The man went to the potato house to make the jump
Ri ixoq xbʼeek chi rtaqxik qʼaʼtzuy praal cheʼ	#qum# La mujer fue a buscar hongo en la	️ Man has made the work in the field of earth
Paqʼiij xoʼkik ri elqʼoom pjaay elqʼnel	#qum# De día ent raron los ladrones en la casa a robar	The man has put himself in the head of the house of
Ri qbʼey xsukʼbʼik kumu xqjnumsaj ri qchoqʼaabʼ	#qum# Nuestro camino se	The man has stayed in the woman's house
Ataq xtzaqik ri ajkʼaal xelul kikʼ pirtzaʼm	#qum# C uando cayó el niño le salió sangre en la nariz	️
Ri wochbʼlaal areʼ jun naʼtbʼal qe	#qum# El retrato es algo que nos recuerda	The man who made people
Ataq xi bʼal kqʼiiqʼ ri rwiʼ jaay ktzalbʼik	#qum# Cuando hay mucho aire el techo de la casa	The man has become the man has become the man
Ri raal chiij ktuʼnsxik kumu qal xpon rqʼij	#qum# La cria de la oveja lo amamantan porque	️Mũndũ has become man
Ri yaak xeʼrtij ri raa l akʼ	#qum# El gato de monte se comió todos los pollitos	The man who has gone to earth has not gone to earth.
Ri rkʼoʼxiil ubʼooy kchuknik chu awbʼal	#qum# La	️️️️️️️️️️️️️️️️️️️️️️️️️️️️️️️️️️️️️️️️️️️️️
Ri aliit qal kirkʼut saqsi tzʼeebʼ	#qum# A la muchach a no se le nota que es tartamuda	The man who went to the mother's house
Ri achii xrubʼaaj ri musaat rukʼ ri ubʼ al	#qum# El hombre mató el venado con su	The man has put himself where he has gone
Ri rchiʼ jaay xpaqʼtjik rum ri rkabʼ rqan	#qum# la puerta de la casa se partió por el temblor	The man has gone to the men's house so that the
Ri wnobʼ yuux ri raal	#qum# Mi hernana tiene gemelos	The man has become a woman who has become a woman who
Ri tzʼiʼ xelul qʼaaqʼ chriij	#qum# Al perro le dio fiebre	The man who has made himself for
Ri tatyoox qal chik kirchʼij rjoʼxik ri rsomchiʼ	#qum# El anciano ya no aguanta afeitarse	El hombre que se quedó en la casa de su madre
Njeel ri ajchaak xeʼyoʼqook chu rpaqʼik ri uleew	#qum# Todos los trabajadores les pusieron a	The man has become the man who has gone
Njeel ri ajchaak xeʼtobʼik chu rmolik ri abʼaj	#qum# T odos los trabajadores ayudaron para juntar la	"""Tú eres un hombre que te lo has hecho""."
Wu ulee w naʼl xtzʼaqik	#qum# La tierra se tiene que compactar bien	The man put on his head to do the work
Ri wix kir qchʼuj ri paan	#qum# El gato le dió un mordisco al pan	The man stopped on the way to Jesus' house
Ataq xojelbʼik qonjeel x qtzʼap ijken ri rchiʼ jaay	#qum# Cerrado	The man has become the man
Ri rchʼmeʼy ntatanool xq ʼajik	#qum# El bastó n de mi abuelo se quebró	Mens took the woman's place
Ri abʼaʼ bʼantlik rukʼ saqkiiy	#qum# La hamaca está hecha de pita de mecate	The man went to the men's house so his arms wouldn't be waking up
¿Cuánto cuesta el sombrero que compró mi mamá en la plaza	#qum# ¿cuándo?	The man who left the street hasn't been seen in the square
R i achii xelbʼik rukʼ ri rtzʼiʼ chu rtaqxik ri musaat	#qum# El hombre salió con su perro a cazar	The man has gone to the woman's house
Ri chʼooy xchʼulchʼaʼ ri ixiim	#qum# El ratón ensuscio todo el maíz fracción/ pedazo	️️️Chemanato:
Njeel ri wnaq nim ri knoʼj sichaʼ utz ikʼolik	#qum# Toda la gente tienen buena ineligencia por eso están bien	The man has gone to the house of God to be taken to the house of the
Ri nchuch xtzaltzaj ri poʼt ri xloqʼ kumu nuchʼ xkanaj chriij	#qum# Mi mamá tuvo que	The man has gone out onto the street to do the work in the woman's house
Ri keqʼ kiryaʼ ptaq ri rqan swon	#qum# La Guayaba se da en los barrancos	The man has become the man in the earth world
Ri kuch xkchʼulchʼaʼ ri kwoy	#qum# Los c erdos ensuciaron la comida	The man is the one who has gone to do the work
Cuando oímos el río tumbar rápido corrimos	#qum# Bejuquillo	The man who made himself the man has gone to the house of men
Ajwiʼ xtpetik jabʼ rukʼ saqbʼuch	#qum# Hoy va llover con granizo	The man has gone to the men's house
Ri tzʼiʼ xkbʼalktij kiibʼ rukʼ ri sjiʼl	#qum# El perro se revolcaron con el coyote	The man has become the man has become man
Riliil riij ataq xkojwaʼljik xkojtyoxnik chu Ajaw	#qum# Es necesario cuando amanecemos debemos agradecer a Dios	The man who went to the street hasn't gone home
Kqʼoxwik ri nxkin	#qum# Me duele el oído	️️️️️️️️️️️️️️️️️️️️️️️️️️️️️
Ri ntzʼiʼ naqʼtlik kirtij iik	#qum# Mi perro está acostumbrado comer chile	The man became the man in the woman's house
Ptaq ri rqan swon kiryaʼ xibʼal ri chibʼaʼ	#qum# En los barrancos se da mucho el helecho	The man went into the water so the water wouldn't get him
R i ajtʼisnel xwiʼtxik kum ri elqʼoom	#qum# El sastre fue matado por los ladrones	The man has taken the place of the man who went to get
Ri ajtiij xbʼ iij chke ri ajtijnel kʼotz kixkʼ olaq	#qum# El maestro dice a los estudiantes que guarden	The man has set himself on the road to get the water
Ataq xeʼriqtjaq ri ixoq juplik bʼanmajken chre	#qum# Cuando le fueron a encontrar a la mujer la	️ The man has become a man who has become a woman
La orina apesta mucho cuando hay mucho calor	#qum# Camarón	The man has become the man who has left his father's house.
Nim ri kaʼy kbʼanik chu ri waʼktbʼal	#qum# Mucha diversión se hizo en el parque	️The man who has become the man has gone to the woman who has
Ri yaaj utz xttijxik chke ri ajkʼlobʼ	#qum# El regaño es bueno enseñarles a los niños	The man who made the woman
Wu kuuk xkʼis ri a j chtijik	#qum# La ardilla se terminó de comer los elotes	The man who stayed in the spot
