input	reference	prediction
wu rxqiil taʼ xuux xaq utz laj siʼ kchuknik chre	#qum# La esposa de don Jesus solo utiliza buena leña	                                                                                                  
Njeel ri xkarawaʼn xpochʼik rech chenim xchaqʼjik	#qum# Todo la arveja se	Njeel ri xkarawaʼn xpochʼik rech chenim xchaqʼjik
Pri qtinmit qal chik kchkunsxik ri qyolbʼaal	#qum# En nuestro pueblo ya no se usa nuestro idioma	
Ri ajtijnel tjin kirtijuuj c hemo rchkunsxik ri suʼ	#qum# El estudiante está aprendiendo como	                                                                                                  
Ri ixoq tzʼulmaj rum ri rchjiil	#qum# La mujer estaba abrazada por su marido	
Rukʼ taʼ Francisco chwaʼq xtbʼanik awaʼn	#qum# Mañana van a sembrar con don Francisco	Rukʼ taʼ Francisco chwaʼq xtbʼanik awaʼn
Chwoch ri jaay kʼolik jun tzʼapiibʼ	#qum# Alrededor de la casa hay un cerco	                                                                                                  
Los jóvene s todos los días juegan en el campo Perjuicio	#qum# Ataq	Los jóvene's todos los días juegan en el campo Perjuicio
Ataq xchupik ri nchuch xinkanajken pri bʼiis	#qum# Cuando murió mi mamá me quedé en la tristeza	
Ri ixoq xchupik rum wu rchuch rkʼuʼx	#qum# la mujer se murió de la matriz	                                                                                                  
Oxej xtqriq qiibʼ chi ryolik ri chaak	#qum# Entre tres días nos encontramos para platicar del	xtqriq qiibʼ chi ryolik ri chaak
Chke ri ajkʼ a lobʼ qal utz xtnaqʼsxik ri elqʼneem	#qum# A los niños no es bueno enseñarles a	                                                                                                  
Ri rxaq limobʼ utz kchuknik chi ri qʼyees	#qum# La hoja de aliso es bueno para la broza	Rxaq limobʼ utz kchuknik chi ri qʼyees
Ri keej xtzaqik rum wu xaq et rchim	#qum# El caballo se cayó por mucha carga	Ri keej xtzaqik rum wu xaq et rchim
Ri ajkʼal kjilpji k pri riij loʼn	#qum# El bebé resbaló en la cascara de la fruta	Ri ajkʼal kjilpji k pri riij loʼn
Ri tatyoox xyaʼken njeel ri uleew chu ri rmon	#qum# El señor le dejo toda la tierra a su nieto	                                                                                                  
Wu xjabʼ koʼl xiʼ kanajken pirqan wu aliit	#qum# Los zapatos de la señorita les quedo flojo Jaula	xjabʼ koʼl xiʼ kanajken pirqan wu aliit
Wu saqtbʼiin mixeʼrkʼis ri akʼ c htijik	#qum# La comadreja se terminó de comer las gallinas	Wu saqtbʼiin mixeʼrkʼis ri akʼ c htijik
Kji bʼ nmaq meex xkiʼchuknik rech weʼbʼal	#qum# Cuatro mesas grandes servirán para comer	                                                                                                  
Njeel ri tzʼibʼbʼal jachmaj chik chke ri ajkʼalobʼ	#qum# Todos los lapiceros ya están divididos a los niños	Njeel ri tzʼibʼbʼal jachmaj chik chke ri ajkʼalobʼ
Ri rqan ooj tjin rchiqik rum wu tzrabʼ	#qum# La mata de aguacate se está secando por el	                                                                                                  
Ataq kojqajbʼik chchiʼ ri yaʼ xibʼal kliswik	#qum# Cuando bajamos a la orilla del río es muy	Ataq kojqajbʼik chchiʼ ri yaʼ xibʼal kliswik
Ri achii ataq kirbʼsuj rbʼanik jun chaak, xtbsuj ri qʼiij chu rkʼisbʼaal	#qum# El hombre cuando	                                                                                                  
Tzʼajtzʼik rkaʼyxik ri rwoch ri waakx	#qum# La cara de la vaca se ve alargada	T'ajtz'ik rka'yxik ri roch ri waakx
Wu am kertij ri us ri ikʼoʼk chu xaan	#qum# La araña come las moscas que están en la pared	Wu am kertij ri us ri ik'o'k chu xaan
Ataq kpetik nim jabʼ xibʼal ri senyabʼ	#qum# Kkanjik	Ataq kpetik nim jabʼ xibʼal ri senyabʼ
Ri wjow kʼiy richlaal sichaʼ qal kkʼuqbʼik chjaay	#qum# mi papá tiene muchos parientes por eso no se mantiene en la casa	Ri wjow kʼiy richlaal sichaʼ qal kkʼuqbʼik chjaay
Ataq kpetik jabʼ njeel ri qʼoos krexbʼik	#qum# Vejez	Ataq kpetik jabʼ njeel ri qʼoos krexbʼik
Njeel ri ixiim xpokʼrik	#qum# Todo el maíz se apolillo	                                                                                                  
Ri uleew tjin rmeqʼik rum wu kʼex ri tjin kirbʼan ri achii chre	#qum# por el daño que el hombre está	Uleew tjin rmeqʼik rum wu kʼex tjin kirbʼan ri achii kr
Ri qʼoor chqaam xelul	#qum# La masa salió quebrada	Ri qʼoor chqaam xelul
Ri limeet kchuknik chi r kʼolik ri ryaʼl chʼoxiʼ	#qum# La botella se utiliza para guardar miel	Ri limite k'chuknik chi r'k'olik ri rya'l ch'oxi'
Joʼ qonjeel rech xkojtaʼtjik che ri qajbʼeej	#qum# Vamos todos para que nos atieden nuestra	Joʼ qonjeel rech xkojtaʼtjik che ri qajbʼeej
Ri nimaya ʼ xkʼiyik sichaʼ xuʼrmaʼ njeel ri tikaʼ	#qum# El río creció por eso se llevó toda la	nimaya xkʼiyik sicha xuʼrma njeel ri tika
Jomom ri cheʼ sichaʼ xkʼeq rquljaay	#qum# El árbol es grandicimo por eso le pego el rayo	Jomom ri cheʼ sichaʼ xkʼeq rquljaay
Ri knaqʼ ri kloqʼik pkʼeybʼal esmaj jun pajbʼal	#qum# El frijol que se compra en la plaza lo	Ri knaqʼ ri klqʼik pkʼeybʼal esmaj jun pajbʼal
Ataq kintij knaqʼ kiryaʼ qʼaʼteew chwa	#qum# Cuando cómo frijol me da ardor de pecho	Ataq kintij knaqʼ kiryaʼ qʼaʼteew chwa
Njeel wu loʼn jexmaj rukʼ qʼatbʼal	#qum# Todas las frutas están rodajeada con cuchillo	Njeel wu loʼn jexmaj rukʼ qʼatbʼal
Iwir ri nchuch xloqʼ bʼatzʼ pkʼeybʼal jaljoj kkaʼybʼaal	#qum# Ayer mi mamá compró hilo de varios colores	Iwir ri nchuch xloqʼ bʼatzʼ pkʼeybʼal jaljoj kkaʼybʼaal
Ri elqʼoom xqitxik kum ri wnaq xaq rum wu xrelqʼaaj jun keej	#qum# El ladrón fue arrastrado por las	                                                                                                  
Ri rqan kiiy tjin rchiqik rum wu xoʼkik chkop txeʼ	#qum# Las matas de maguey se están secando por la plaga	Rknnnnnnnnnnnnnnnnnnnnnnnnnnnnnnnnnnnnnnnnnnnnnnnnnnnnnnnnnnnnnnnnnnnnnnnnnnnnnnnnnnnnnnnnnnnnnnnnn
Ataq ktijik jun chooj nim rkunaal kraaj	#qum# Cuando se come un chompipe quiere mucho	                                                                                                  
Njeel ri rwiʼ jaay ktzʼujik	#qum# Todo el techo de ,la casa gotea	Njeel ri rwiʼ jaay ktzʼujik
El enfermo se empeoro porque salio bajo la lluvia	#qum# Quemar bien	El enfermo se empeoro porque salía bajo la lluvia
Ri molbʼeem kbʼanik chwuqubʼ qʼiij	#qum# La reun ion se realiza cada semana	Ri molbʼeem kbʼanik chwuqubʼ qʼiij
Ri cheʼ xchiqik ri rxaq	#qum# El árbol se le seco las hojas	                                                                                                  
Rukʼ wu joʼq keʼ bʼanik qʼus laj alaʼs	#qum# Con el doblador se hacen muñecas decoradas	Rukʼ wu joʼq keʼ bʼanik qʼus laj alaʼs
Julajuuj chiij xeʼr tij ri sjiʼl	#qum# el coyote se comió l as once ovejas	Julajuuj chiij x'r tij riji'l
Ri achii xkʼoxbʼsaj ri rjlom ataq xtzaqik rukʼ ri jochlan chʼiichʼ	#qum# El hombre se go lpeó la	                                                                                                  
Ri knaqʼ saqtbʼin chetzʼiʼnik rtijik pjkʼom iik	#qum# El frujol blanco es delicioso comer en	Ri knaqʼ saqtbʼin chetzʼiʼnik rtijik pjkʼom iik
El cerdo ensució el maíz	#qum# L avado	El cerdo ensució el maíz
Ri ixoq kiʼrbʼan ri klobʼ rukʼ ri saqkiiy ri kirbʼan rukʼ ri choʼl	#qum# La mujer hace lasos con la	Ixoq kiʼrbʼan ri klobʼ rukʼ ri saqkiiy ri kirbʼan rukʼ ri choʼl
Chetzʼiʼnik rtijik ri qʼooqʼ	#qum# El ayote es bien rico pa ra comer	                                                                                                  
Nqaaj waʼchiʼ xchupik ri rchjiil ri ixoq	#qum# Cerca murió el marido de la mujer	Nqaaj waʼchiʼ xchupik ri rchjiil ri ixoq
Njeel ri subʼ tijmaj rum chʼoo y ataq xojsaqrik	#qum# Todo el tamal estaba comido por las ratas	Njeel ri subʼ tijmaj rum chʼoo y ataq xojsaqrik
Ataq kiʼjikxik ri cheʼ ri uleew sbʼajbʼoj kkanjik	#qum# Arena	Ataq kiʼjikxik riʼ cheʼ ri uleew sbʼajbʼoj kkanjik
Ri tzʼqubʼ kchuknik chu ri jsol cheʼ	#qum# El formón lo utiliza el carpintero	                                                                                                  
Ri imul ataq kʼolik rqan iikʼ kelul chirtijik wu knaqʼ	#qum# El conejo cuando hay buena luna sale a comer el frijol	Ri imul ataq kʼolik rqan iikʼ kelul chirtijik wu knaqʼ
Ri ixoq ataq xwiʼtaaj ri akʼ kʼa xlechʼpij ri rtzʼumil	#qum# La mujer cuando mató a la gallina	                                                                                                  
Ri rjujil uleew xsibʼrik wu riij	#qum# El documeto del terreno está ahumado	Rjujil uleew xsibʼrik wu riij
Ri tzʼtuj ktij tochʼaʼ chu kwoy	#qum# La flor de milpa lo come las chorchas	Ri tzʼtuj ktij toʼaʼ chu kwoy
Riliil riij xtloqʼxik ri uleew	#qum# Es necesario cuidar la naturaleza	Riliil riij xtloqʼxik ri uleew
Ri knimalil ri ajkʼalobʼ ktij tzʼiʼlil	#qum# La mayoría de los niños consumen mucha galguería	Ri knimalil ri ajkʼalobʼ ktij tzʼiʼlil
Ataq kokik saqʼiij yaax keʼlik ri waakx	#qum# Cuando entra el verano las vacas se ponen flacos	Ataq kokik saqʼiij yaax keʼlik ri waakx
Ri ajkʼaal xwochʼ wu rwiʼ rqʼabʼ	#qum# El niño se majó el dedo	                                                                                                  
Ri nchuch xloqʼ ri paa kʼ pkʼeybʼal	#qum# Boca arriba	                                                                                                  
Ri ajkʼaal qal xchʼij kumu kʼten yaʼ xtixuul chriij	#qum# El niño no guantó porque se le regó agua	Ri ajkʼaal qal xchʼij kumu kʼten yaʼ xtixuul kriij
Wu puʼt kxikʼnik chu taq ri kotzʼaj	#qum# La mariposa vuela entre las flores	Wu put kxikʼnik chu taq ri kotzʼaj
Njeel ri ya abʼ mixuʼtzrik	#qum# Todos los enfermos sanaron	Njeel ri ya abʼ mixuʼtzrik
Ri chnooj xchiqik kumu xqaaj teew chriij	#qum# La milpa se secó porque le cayó hielo	
Ri xpley kiryaʼ ataq jnum kawxik rukʼ ri chnooj	#qum# El frijol amarillo da cuando se siembra	xpley kiryaʼ ataq jnum kawxik rukʼ ri chnooj
Ri yaʼ kʼolik rsaqiil	#qum# El agua tiene pureza	Ri yaʼ kʼolik rsaqiil
Jutzʼjik rkaʼxik ri rwiʼ rchoch wjow	#qum# El techo de la casa de mi papá se ve de forma triangulo	                                                                                                  
Ataq koʼqʼoʼk ri toltol chjaay labʼnel kʼolik chinaq xtkmik	#qum# Cuando el buhuo llega a	Ataq koʼqʼoʼk ri toltol chjaay labʼnel kʼolik chinaq xtkmik
Ri molbʼeem kech ri aj tijnel xbʼanik kabʼjiir	#qum# La reunión de los estudiantes se hizo anteayer	                                                                                                  
Ri nchuch kʼolik rmkoom	#qum# Mi mamá tiene sirvienta	
Ri ajkʼalobʼ xeʼoqʼik rum qal xkchʼak ri etzʼnim	#qum# Los niños empezaron a llorar cuando perdieron	Ri ajk'alob' xe'oq'ik rum qal xk'ch'ak ri etz'nim
Ri qyolbʼaal areʼ ri Sipakapense	#qum# Nuestro idioma es el Sipakapense	                                                                                                  
Xaq qiʼn chik qal xmaj qʼaaqʼ ri jun jaay chik	#qum# Por un poco no alcanzo el fuego la otra casa	Xaq qiʼn chik qal xmaj qʼaaqʼ ri jun jaay chik
Ri rbʼaqʼ rwoch wnaq kirbʼan kʼex chke ri ajkʼ a lobʼ	#qum# El mal de ojo les afecta a los	Rbʼaqʼ roch wnaq kirbʼan kʼex chke ri ajkʼ a lobʼ
Qal utz xtqtij ri chʼqaap	#qum# No es bueno comer el sobrante al otro día	Qal utz xtqtij ri ch'qaap
Chke njeel ri wnaq xbʼiʼxik ke qal xeʼlbʼik xkoybʼeej ke xkʼisik ri molbʼeem	#qum# A todas las	Chke njeel ri wnaq xbʼiʼxik ke qal xeʼlbʼik xkoybʼeej ke xkʼisik ri molbʼeem
Rech ri nima qʼiij rech tinmit qonjeel qyaʼ ri kchuuj	#qum# Para la fiesta del pueblo todos damos la contribución Ri achii xkanajken	R
Njeel ri chaak ri xbʼanik bʼusmaj riij sichaʼ utz xeʼloq	#qum# Todo el trabajo que se realizó estaba bien pensado por eso salió bien	Njeel ri chaak ri xbʼanik bʼusmaj riij sichaʼ utz xeʼloq
Tukkilaʼ kʼolik r i rchoch ri wnobʼ	#qum# Por allá está la casa de mi hermana	Tukkila kʼolik rʼi rʼokch ri wnob
Njeel ri kotzʼaj ri rawmaj ri nchucch keq rkaʼybʼaal	#qum# Las flores que tiene sembrado mi mamá son de color rojo	
Ri kchak ri ojor wnaq qaqchee chik kiʼ riqt jik	#qum# Los trabajos de los antiguos ya no se encuentran	                                                                                                  
Ri saqbʼuch xkʼoxbʼsaaj ri chno oj	#qum# El granizo golpeo la milpa	Ri saqbʼuch xkʼoxbʼsaaj ri chno oj
wu ajkʼaal kiryaʼ achyam chre	#qum# Al niño le da estornudo	u ajkʼaal kiryaʼ achyam chre
Pongale una cuña a la mesa	#qum# Codo	Pongale una cuña a la mesa
Cha niim xojelbʼ ik sichaʼ xojtz aljuul jnum	#qum# Salimos rápido por eso regresamos juntos	Cha nim xojelb' ik sicha' xojtz aljuul jnum
Ri rtzʼibʼbʼaal ri ajtijnel xqʼeptjik	#qum# El lápiz del estudiante se quebró	Rtzʼibʼbʼaal ri ajtijnel xqʼeptjik
Ri rwiʼ ri aliit pochʼmaj rukʼ ri rxqʼap	#qum# El cabello de la señorita está trensado con su	Rwiʼʼriʼit pochʼmaj rukʼʼ ri rxqʼap
Chu ri qʼtal iil qal ri tzujnel xopnik	#qum# Ante el juez no se presentó el acusador	
Estaba mojado la camisa del hombre por eso le dio fiebre	#qum# C ama wu chʼaat bʼantlik rukʼ	Estaba mojado la camisa del hombre por eso le dio fiebre
ri achii kʼolik rsmaal chu rkʼuʼx	#qum# El hom bre tiene bellos en el pecho	                                                                                                  
La tabla es ancha	#qum# Pizarron	La tabla es ancha
Ri neʼ kchaknik pirqan jaay	#qum# El bebé gatea en el patio de la casa	Ri neʼ kchaknik pirqan jaay
Kʼolik wnaq qal chik knaʼtaj ri kbʼanbʼaal chke	#qum# Hay personas que ya no se recuerda de	Kʼolik wnaq qal chik knaʼtaj ri kbʼanbʼaal chke
Wu ixoq kjororik wu rtzaʼm ataq kwrik	#qum# La señora ronca mucho cuando duerme	                                                                                                  
Ri rxaq juuj xaq qiʼn nakʼlook	#qum# La hoja de papel esta medio pegado	Rxaq juuj xaq qiʼn nakʼlook
Ri wnaq ataq kʼolik jun chʼoʼj chkxoʼl ketzlaj kiibʼ	#qum# La gente cando existe entre ellos un problema se desprecian	Ri wnaq ataq kʼolik jun oʼj kxoʼl ketzlaj kiibʼ
Ri tʼiqbʼal kchuknik chu rnukʼik ri qʼaaqʼ	#qum# El encendedor sirve para juntar el	Ri t'iqb'al kchuknik chu rnuk'ik ri q'aaq'
Ataq kmo lik ri knaqʼ kʼolik rkʼolbʼaal waʼchiʼ kyoʼqqaj wiʼ	#qum# Cuando se junta	Ataq kmo lik ri knaqʼ kʼolik rkʼolbʼaal waʼchiʼ kyoʼqqaj wiʼ
Ri waʼchiʼ kʼo ri wchoch mqʼen jyubʼ	#qum# Donde yo vivo es tierra caliente	Ri waʼchiʼ kʼo ri wchoch mqʼen jyubʼ
Ataq kojsaqrik ri tzeek koqʼik	#qum# C uando amanecemos el gallo canta	Ataq kojsaqrik ri tzeek koqʼik
Njeel ri teem isetsik	#qum# Todas las bancas son redondas	                                                                                                  
Ataq kjachʼik ri jal xaq xeew ri rqan chnooj kkanjik	#qum# Cuando se tapisca la	                                                                                                  
wu qʼoor kookʼ xelul pwu keʼbʼal	#qum# La masa salió fino en el molino	uor kook xeluluuuuuuuuuuuuuuuuuuuuuuuuuuuuuuuuuuuuuuuuuuuuuuuuuuuuuuuuuuuuuuuuuuuuuuuuuuuuuuuuuuuuuuuuuuuuuuu
Tráigalo	#qum# Ri ixoq	                                                                                                  
Rwaqlaaj rjnobʼ ri tijbʼal xtzʼaqtik	#qum# La escuela cumplió el decimo sexto año de	Rwaqlaaj rjnob  ri tijbʼal xtzʼaqtik
Ri loʼn chʼomchʼoj rtijik	#qum# La fruta está medio ácido	Ri loʼn chʼomchʼoj rtijik
Ri rxjabʼ ntatanool qʼeq kkaʼybʼaal	#qum# Los zapatos de mi abuelo es de color negro	Rxjabʼ ntatanool qʼeq kkaʼybʼaal
Njeel ri rxaq juuj xeʼ worik	#qum# Todas las hojas de papel se perforó	                                                                                                  
Ri waakx lewlik wu rwoch	#qum# La vaca es de mejilla gorda Extendido	Ri waakx lewlik wu rwoch
Chu kxibʼxik ri chʼok kchuknik ri ixkeeqʼ	#qum# Para espantar a los zanates sirve la onda de pita	Chu kxibʼxik ri chʼok kchuknik ri ixkeeqʼ
Njeel ri ajkʼalobʼ xiʼ tuknik rum xibʼal kiibʼ	#qum# Todos los niños se dispersaron por el miedo	Njeel ri ajkʼalobʼ xiʼ tuknik rum xibʼal kiibʼ
Ri achii riʼj chik sichaʼ qal kirchʼij kbʼinik	#qum# El hombre ya es viejo por eso no aguanta caminar	Ri achii riʼj chik sichaʼ qal kirchʼij kbʼinik
Riliil riij xtkʼutik ri kajwxik rbʼanik kukʼ ri wnaq	#qum# Es necesario mostrar lo que se quiere	Riliil riij xtkʼutik ri kajwxik rbʼanik kukʼ ri wnaq
Ri yuʼtz kʼebʼ muul xchuknik sichaʼ kamulbʼal rbʼiʼxik pqyolbʼaal	#qum# La	Ri yuʼtz kʼebʼ muul xchuknik sichaʼ kamulbʼal rbʼiʼxik pqyolbʼaal
Wu leem xkʼis ri knaqʼ	#qum# La tortuguilla terminó de comer el frijol	Wu leem xkʼis ri knaqʼ
Wu jaws kkeʼxik chu kʼej	#qum# L a haba se muele para pinol	Wu jaws kkeʼxik chu kʼej
Wu chaak kow sichaʼ qal nim xkbʼan ri ajchaak	#qum# El trabajo está duro por eso no avanzaron los trabajadores	Wu chaak kow sichaʼ qal nim xkbʼan ri ajchaak
Wu nima xbʼoʼj leʼlik wu rchiʼ	#qum# La olla grande es de boca grande	Wu nima xbʼoʼj leʼlik wu rchiʼ
Ri nooy kiʼ qʼoxwik ri rbʼaqil	#qum# La abuela le duele su hueso	Ri nooy kiʼ qʼoxwik ri rbʼaqil
Tkaal xkmik ri ntzʼiʼ rum riʼjaal	#qum# Mi perro se murió despacio ór la vejez	Tkaal xkmik ri ntzʼiʼ rum riʼjaal
Pri molbʼeem xaq kʼeebʼ ixoq xoʼpnik	#qum# En la reunión llegaron solo dos mujeres	                                                                                                  
Saqsi xkojyolwik chqatziij rtqriq kʼchiʼ ri utziil	#qum# Si hablamos con la verdad	Saqsi xkojyolwik chqatziij rtqriq kʼchiʼ ri ri utziil
Pri uleew kʼolik kʼiy amluʼx abʼaj	#qum# En el terreno hay montones de piedras	Pri uleew kʼolik kʼiy amluʼx abʼaj
Rech qal xkojyolik, utz xttojik ri kʼaas	#qum# Para que no nos critiquen es bueno pagar la deuda	R
Ri tikʼlik yaʼ qal utz kumu kiʼ poqʼnik ri raal us	#qum# Las aguas estancadas no es bueno	tik'lik ya' qal utz kumu ki' poq'nik ri raal us
Ri tzʼiʼ xwos	#qum# El perro es travieso	                                                                                                  
Kʼolik ri wnaq qal knmaj ri tyoox	#qum# Existen personas que no creen en las imágenes	Kʼolik ri wnaq qal knmaj ri tyoox
Che rajlbʼaal rkʼosbʼik r i wtziik	#qum# Que fecha nació mi hermano	Che rajlbʼaal rkʼosbʼik r i wtziik
Ri nchuch yaabʼ rukʼ rqul	#qum# M i mamá está enfermo de la tos	R
Ri ajkuun tlaʼ kʼolik rchoch waʼchiʼ rbʼiʼ oxchʼuʼk	#qum# la comadrona vive en el traingulo	Ri ajkuun  kʼolik rchoch waʼchi  rbʼi  oxchʼuʼk
Ri rchaq akʼ utz xtqajik chxeʼ ri tikaʼ	#qum# La gall inaza es bueno para abonar la siembra	Rch ak ut xtqajik chxe ri tika
Ataq kʼolik yaʼ tikʼlik xibʼal serat kiʼpoqʼnik	#qum# Cuando hay charcos de agua	Ataq kʼolik yaʼ tikʼlik xibʼal serat kiʼpoqʼnik
ajsik xokul ri elqʼoom sicha ʼ qal xnaʼ ri tzʼiʼ	#qum# El ladrón entró arriba por eso no se dio cuenta el perro	                                                                                                  
Ataq xkʼosbʼik ri ajkʼaal rbʼaqʼtmaj riibʼ ri rkʼamaʼl rmuux pirqul	#qum# Cuando nacio el niño lo	Ataq xkʼosbʼik ri ajkʼaal rbʼaqʼtmaj riibʼ ri rkʼamaʼl rmuux pirqul
Ri keej bʼilbʼik wu rbʼaq rwoch	#qum# El caballo tiene los ojos grandes	Ri keej bʼilbʼik wu rbʼaq rwoch
El cuarto lo han barrido	#qum# Barrendero	El cuarto lo han barrido
Ri nchuch utz keʼrbʼan ri xkulbʼal	#qum# Mi mamá puede hacer petate	                                                                                                  
Ri pisbʼal ri juuj bʼantlik rukʼ miit	#qum# La en voltura del papel está hecho de algodón	Ri pisbʼal ri juuj bʼantlik rukʼ miit
Njeel ri kʼyeej itzʼaplik	#qum# Todos los negocios están cerrados	Njeel ri kʼyeej itzʼaplik
Xsqarsxik ri riil ri achii se aclaró el delito del hombre	#qum# Dirrecion	
Chpom ri bʼeey xtukxik poqlaaj	#qum# En el camino se regó arena	
Ri sʼaq tʼaq	#qum# La ropa está mojada	Ri s'aq t'aq
Ataq xsiq ri tzʼiʼ ri qan chkop xtrambʼeej rech xwiʼtaaj	#qum# Cuando el perro olió las huellas del	                                                                                                  
Ri aliit xtzaqeel wu rkaʼ	#qum# La señorita se le cayó la muela	Ri aliit xtzaqeel wu rkaʼ
Ri tzʼiʼ xsok ri achii pirsmoqʼ	#qum# El perro lo hirió al hombre en la fosa poplítea	                                                                                                  
Ri siikʼ kirbʼan kʼex chu ri tzantzqʼor	#qum# El consumo del cigarro daña el cerebro	Ri siʼ kirbʼan kʼex chu ri tzantzqʼor
Ataq kpetik jabʼ wu kʼotzʼaj qʼus kkaʼyxik	#qum# Frijol	Ataq kpetik jabʼ wu kʼotzʼaj qʼus kʼaʼyxik
Ataq utz bʼanmaj ri chaak qal chik ktzuntzxik	#qum# Cuando está bien hecho el trabajo no es necesario repasarlo	                                                                                                  
Ri ajmaak areʼ ri achi i ri xwiʼt aaj ri ixoq	#qum# El hombre que mató a la mujer es el culpable	
Ri saqkʼim kchuknik chu kbʼanik xuʼk	#qum# El pajon blanco sirve para elaborar canastas	Ri saqkʼim kchuknik chu kbʼanik xuʼk
Latzʼ wu rpom jaay sichaʼ qal xiʼ kʼisook njeel ri wnaq	#qum# La casa es muy reducido por eso no	Latz' wu rpom jaay sicha' qal xi' k'isook njeel ri wnaq
Ataq kqajik ri nabʼey rqan jabʼ keʼlul ri xkawalek	#qum# Cunado cae las primeras lluvias salen	Ataq kqajik ri nabʼey rqan jabʼ keʼlul ri xkawalek
Ri xbʼaj kirbʼan kʼex chu ri qsosobʼ	#qum# El aguardiente causa daños a nuestro hígado	                                                                                                  
Xeʼ taq ri abʼaj kiʼkʼobʼik ri kmatz	#qum# Debajo de las piedras están las culebras	Xe' taq ri ab'aj ki'k'ob'ik ri kmatz
Ri tikaʼ kkʼiyik rum ri rmeqʼnal ri qʼiij	#qum# La siembra crece con el calor del sol	Ri tikaʼ kkʼiyik rum ri rmeqʼnal ri qʼiij
Waqiibʼ iikʼ chi k xtqajik raal wu wakx	#qum# Entre seis meses va parir la vaca	Waqiibʼ iikʼ chi k xtqajik raal wu wakx
Jun mlol ylooj xb ʼiʼnik re waʼ	#qum# Esto lo dijo un chismoso	                                                                                                  
Ri albʼatz xyoʼqook chu rqirxik ri rwoch ixiim	#qum# La nuera se le puso a	                                                                                                  
Pirwiʼ ri jyubʼ xeʼqbʼnaʼ ri chʼabʼal maaya	#qum# En la cima del cerro fuimos hacer la ceremonia maya	Pirwiʼ ri jyubʼ xeʼqbʼnaʼ ri chʼabʼal maaya
R i alaabʼ xtochʼ ri rqan rukʼ ri tochʼbʼal	#qum# El muchacho se cortó el pie con el machete	                                                                                                  
Ri elqʼoom chaqʼabʼ xkelqʼaaj ri rwaakx wjow	#qum# Los ladrones de noche robaron la vaca de mi papá	                                                                                                  
Ri nanyoox xaq kyabʼabʼ ik rum wu re tzaʼm	#qum# la señora siempre padece del catarro	Ri nanyoox xaq kyabʼabʼ ik rum wu re tzaʼm
Najeʼl xbʼan ri wtziik ri rchoch	#qum# Mi hermano construyó su casa retirado a la mia	Najeʼl xbʼan ri wtziik ri rchoch
Ri aliit nmaq wu riim	#qum# La señorita tiene los pechos grandes	Ri aliit nmaq wu riim
Ri rbʼuch akʼ xnojik rukʼ rwoch ixiim	#qum# El buche de la gallina se llenó con granos de maíz	Rbʼuch akʼ xnojik rukʼ rwoch ixiim
Pri ntinmit qal kʼiy moos ikʼolik	#qum# En mi pueblo hay pocos ladinos	                                                                                                  
Ri tzʼuum xchiqik chu qʼiij	#qum# El cuero se secó en el sol	                                                                                                  
Ri ajkʼaal yaabʼ sichaʼ qal ktzeʼnik	#qum# El niño está enfermo por eso no puede reir	Ri ajkʼaal yaabʼ sichaʼ qal ktzeʼnik
Wu us qal utz laj chkop kir chʼulchʼaʼ ri che ri qtij	#qum# La mosca es un animal malo porque contamina lo	us qal utz laj chkop kir chʼulchʼaʼ ri che ri qtij
Ataq kiʼ waʼljik ri ajkʼalobʼ konjeel keʼ bʼixnik	#qum# Cuando los niños se levantan todos cantan	Ataq kiʼ waʼljik ri ajkʼalobʼ konjeel keʼ bʼixnik
Chke ri ajkʼalobʼ riliil rij xkeʼtijxik rech xkeʼqʼajlaʼnik	#qum# A los niños es necesario enseñarles a saludar	                                                                                                  
Ri ajtzʼibʼnel xeʼrtzʼibʼaaj kʼiy q taʼ pqyolbʼaal	#qum# El escritor escribió varios cuentos en el	Ri ajtzʼibʼnel xeʼrtzʼibʼaaj kʼiy qʼaʼ pqyolbʼaal
Ri ixoq xtzʼonjok jrubʼ rjil wu akʼ	#qum# La señora preguntó cuanto vale la gallina	                                                                                                  
wu klobʼ xyuqpjik ataq xchnaʼnik	#qum# El lazo se estiro porque se mojó	                                                                                                  
La laga rtija sale cuando hay sol	#qum# Sapo	La laga rtija sale cuando hay sol
Ri xaʼk chqiʼj chik	#qum# El trozo ya está seco	Ri xaʼk chqiʼj chik
Ri xenxipr utz chi kunbʼal ri qulaj	#qum# Para curar la tos es bueno el jengibre	
Ri klobʼ ktumxik rukʼ xweelx	#qum# El laso lo hacen torcer con malacates	                                                                                                  
Ri ryaʼl tzmeʼy utz xtqum jun ixoq rech q al ri raal xtokʼwik	#qum# El agua de la	                                                                                                  
Ri qʼabʼreel pakʼlik xkanjik ataq xtzaqik	#qum# El borracho cuando cayó quedó de boca arriba	Ri qʼabʼreel pakʼlik xkanjik ataq xtzaqik
Ri achii ataq xbʼeek chu rkʼamik siʼ qal xkʼambʼik ri rptem	#qum# El hombre cuando se fue a traer leña no llevó su mecapal	Ri achii ataq xbʼeek chu rkʼamik siʼ qal xkʼambʼik ri rptem
Junbʼer xkʼuqbʼsxik ri rwiʼ rqʼabʼ tinmit	#qum# El año pasado se fundó el caserío	nbʼer xkʼuqbʼsxik ri rwiʼ rqʼab tinmit
Njeel jnobʼ kbʼanik ri nimaqʼʼij	#qum# Rech ri tinmit	Njeel jno kʼanik ri nimaqʼij
Ri ixoq xpe saqtqoj chriij	#qum# A la mujer le dió vahído	
Ri alaabʼ xtzaqik xqʼoch wu rqʼabʼ	#qum# El muchacho se cayó y se quebró la mano	Ri alaabʼ xtzaqik xqʼoch wu rqʼabʼ
Ri wtziik xaq xchʼutij ri rchoch	#qum# Mi hermano apuntaló su casa	                                                                                                  
Chqʼayaʼpon ri yaʼ kʼolik rchoch ri Leʼn	#qum# al otro lado del rio está la casa de Elena	                                                                                                  
wu ekʼaʼ kchuknik chu wiqbʼal	#qum# La cola de gallo sirve para adornar	                                                                                                  
Iwir xintzaqken ri qʼaxbʼal chaʼnbʼal ayer perdí el teléfono	#qum# Dolor	Iwir xintzaqken ri qʼaxbʼal chaʼnbʼal ayer perdí el teléfono
Ri wkaan kʼolik kʼeebʼ rmyaʼlbʼaal	#qum# Mi tío tiene dos hijastras	Ri wkaan kʼolik kʼeebʼ rmyaʼlbʼaal
Ri saqʼuul xaq tqʼaaj kiryaʼ wiʼ, El plátano solo se da en la costa	#qum# Palo blanco	Ri saqʼuul xaq tqʼaaj kiryaʼ wiʼ, El plátano solo se da en la costa
Iwir xqʼeq xojkʼobʼik pjun molbʼeem	#qum# Ayer en la tarde estuvimos en una reunión	Iwir xqʼeq xojkʼobʼik pjun molbʼeem
Ri ajkʼaal riliil rij kyuqxik chu ri rqʼabʼ	#qum# El niño se debe agarrar de la mano	                                                                                                  
Ri ajtiij xkʼuqbʼaʼ ri tatanool chu teem	#qum# El maestro lo mando a serntar al abuelo en la silla	                                                                                                  
Qonjeel qqum qʼoor	#qum# Todos tomamos atol	
A qué hora nos vamos al entierro	#qum# Dentro de un año	A qué hora nos vamos al entierro
Wu loʼn nmaq kkaʼyxik	#qum# Las frutas se ven grandes	Wu loʼn nmaq kkaʼyxik
Ri kuch xibʼal squkʼ chriij	#qum# El cerdo tiene mucho piojo	Ri kuch xibʼal squkʼ kriij
Ri lochʼ qal xchʼij ri qʼaaqʼ xelul chriij	#qum# El bebé no aguantó la fiebre	Ri lochʼ qal xchʼij ri qʼaaqʼ xelul kriij
Ri aliit ataq kbʼeek pchʼiichʼ kiryaʼ xaʼw chre	#qum# la señorita cuando viaja en carro le da vómito	Ri aliit ataq kbʼeek pʼiichʼ kiryaʼ xaʼw kré
Ri winaq keʼchʼoʼ jnik chrij ri yaʼ	#qum# La gente pelean por el agua	Ri winaq keʼchʼoʼ jnik kri ri yaʼ
Ri wjow njeel qʼiij qal jamlik	#qum# Mi papá todos los días se mantiene ocupado	Ri wjow njeel qʼiij qal jamlik
Chu wu jaay rech chʼabʼal kʼolik kʼeebʼ mulmik uleew	#qum# En frente la iglesia	Chu wu jaay rech chʼabʼal kʼolik kʼeebʼ mulmik uleew
Ri cheʼ qʼeʼlik xk anjik pri bʼeey	#qum# el árbol quedó atravesado en el camino	Ri che e lik xk anjik pri bey
Ri chiij qʼeqqʼoj rkaʼybʼaal	#qum# El color de la oveja es medio negro	Ri chiij qʼeqqʼoj rkaʼybʼaal
Riliil riij ataq xtqum ri yaʼ nabʼeey xtrqowsxik	#qum# Es necesario cuando tomamos el agua	Riliil riij ataq xtqum ri yaʼ nabʼeey xtrqowsxik
Ri rwoch tikaʼ kkiʼyrik rum wu rtun qʼiij	#qum# La fruta se endulza con los rayos del sol	R R R R R R R R R R R R R R R R R R R R R R R R R R R R R R R R R R R R R R R R R R R R R R R R R R R R R R R R R R R R R R R R R R R R R R R R R R R R R R R R R R R R R R R R R R R R R R R R R R R R R R R R R R R R R R R R R R R R R R R R R R R R R R R R R R R R R R R R R R R R R R R R R R R R R R R R R R R R R R R R R R R R R R R R R R R R R R R R R R R R R R R R R R R R R R R R R R R R R R
Ri rwoch nuxtaʼ xibʼal rkʼixil	#qum# La fruta del nopal tiene mucha espina	R R R R R R R R R R R R R R R R R R R R R R R R R R R R R R R R R R R R R R R R R R R R R R R R R R R R R R R R R R R R R R R R R R R R R R R R R R R R R R R R R R R R R R R R R R R R R R R R R R R R R R R R R R R R R R R R R R R R R R R R R R R R R R R R R R R R R R R R R R R R R R R R R R R R R R R R R R R R R R R R R R R R R R R R R R R R R R R R R R R R R R R R R R R R R R R R R R R R R R
Ri aliit kiryqʼuj ri ajkʼaal	#qum# La señorita c uida al bebé	                                                                                                  
Chpom ri yaʼ piʼlik xibʼal xaʼn	#qum# En el agua encharcada hay mucho zancudo	pm ri ya pilik xibal xan
Ri tzʼiʼ ktzʼuʼynjik ataq kirkaʼyij wu rxoqʼjowil	#qum# El perro ronronea cuando mira su	                                                                                                  
Ataq xojopnik jaqlik chik ri rchiʼ jaay jroq koʼkik elqʼoom	#qum# Cuando llegamos ya estaba abierto la	Ataq xojopnik jaqlik chik ri rchiʼ jaay jroq koʼkik elqʼoom
Ri ajkʼaal xyabʼrik rukʼ xjir	#qum# El niño se enfermo de dearrea	Ri ajkʼaal xyabʼrik rukʼ xjir
Ri snik ktij ri rxiʼl leej	#qum# Las hormigas comen la migaja de tortilla	
Ri kiʼ wiqnik ri nima qʼiij areʼ ri qʼus laj taq ixoq	#qum# Los que engalanan la fiesta son las bellas mujeres	Ri kiʼ wiqnik ri nima qʼiij areʼ ri qʼus laj taq ixoq
Ri traas spoqʼpoj rtijik	#qum# El durazno está desabrido	                                                                                                  
Ri wiqabʼaaq kchuknik chu ri qʼajaʼ	#qum# La sábila es bueno para las quebraduras	                                                                                                  
Ri ajkʼa al qal chik xtuʼnik rum wu xsopjik wu rqul	#qum# El bebé ya no pudo mamar porque se le	Ri ajkʼa al qal chik xtuʼnik rum wu xsopjik wu rqul
Qonjeel wu ojkʼolik chu rwoch paxil nkareʼ xaq jnum ri qbʼanbʼaal	#qum# Todos los	
Ri alaabʼ xwiʼtaj jun kuuk rukʼ ri r chʼaabʼ	#qum# El m uchacho mató una ardilla con su onda	                                                                                                  
Ri rchʼeek wtziik xqʼajik ataq xtzaquul jun xaʼk chriij	#qum# La rodilla de mi hermano se quebró cuando le cayó un trozo encima	                                                                                                  
Ri wurbʼal kchʼajchʼtik	#qum# El dor mitorio es limpio	Ri wurbʼal kʼajchʼtik
Ri chʼiichʼ suukʼ xbʼeek pswon	#qum# El carro se fue directo al barranco	Ri i suuk xbek pswon
chpom ri uleew kʼiy kʼulbʼat ikʼolik	#qum# En el terreno hay varios muros	pm ri uleew kiy kulbat ikolik
Jumul xtbʼiʼxik ke ri qatz riliil riij areʼ ri nimneem	#qum# Una vez se dice que lo más importante es el respeto	Jumul xtʼiʼxik ke ri qatz riliil riij are ri nimneem
Ri ryaʼl iik tzeytzoj xelik	#qum# El caldo salió medio salado	Ri ryaʼl iik tzeytzoj xelik
Ataq kojbʼinik nim tʼuus keʼlik ri qqan	#qum# Cuando caminamos mucho los pies nos	Ataq kojbʼinik nim tʼuus keʼlik ri qqan
Ataq xinsol ri kʼaam xinbʼotzʼ chrij jun piʼq	#qum# Cuando desaté la pita es fácil arrollar en un olote	                                                                                                  
Xibʼal rkʼixil ri yeel	#qum# El chichicaste tiene mucha espina	Xibʼal rkʼixil ri yeel
Pri nimaqʼiij xeʼchuknik kʼeebʼ ulanel	#qum# Para la fiesta trabajaron dos recepcionista	Pri nimaqʼiij xeʼchuknik kʼeebʼ ulanel
Chke xyoʼqik njeel ri poq chi rbʼanik ri nimaqʼiij	#qum# A ellos les dieron el dinero para hacer la fiesta	                                                                                                  
Ri wkaaqʼ areʼ jun utz laj achii	#qum# Mi sobrino es un buen hombre	Ri wkaaqʼ areʼ jun utz laj achii
Ri tzʼuu m likʼmaj rwoch chu uleew	#qum# El cuero estaá extendido en el suelo	R
Rum wu qal tzʼqaat ri rpajbʼaal ri ajkʼeynel sichaʼ xbʼeek pcheʼ	#qum# Por estar	Rum wu qal tz'qaat ri rpajb'aal ri ajk'eynel sicha' xb'eek pche'
Ri qʼoor qal xqumik kʼten xtewrsxik tekʼchi xjachik	#qum# El atol no se pudo tomar	Ri qʼoor qal xqumik kʼten xtewrsxik tekʼchi xjachik
Ri wakx jurjik ri raaqʼ La vaca tiene la lengua larga	#qum# Temascal	                                                                                                  
Qal utz xtqyaʼ jun che chqoom ri wnaq kʼa krechbʼeej	#qum# No es bueno prestar algo a alguien porque se adueña	Qal utz xtqyaʼ jun che chqoom ri wnaq kʼa krechbʼeej
Ri tzʼuum ri kʼaʼn chu ri kʼuqulbʼal mixjarik	#qum# El cuero que tiene el sentadero se	                                                                                                  
Ri achii ataq kir bʼan ri awaʼn kertaqiij ajchaak chu rtoxik	#qum# El hombre cuando siembra busca	                                                                                                  
Xkmik ri tʼuq laj akʼ	#qum# La gallina clueca se mur ió	                                                                                                  
Ri nchuch xloqʼ jun suʼbʼal qʼabʼ	#qum# Mi mamá compró una servilleta	Ri nchuch xloqʼ jun suʼbʼal qʼabʼ
Utz xtqsipaj ri poq nuʼj chke ri mebʼaʼ	#qum# es bueno regalar dinero pero a los huérfanos	Uzz xtqsipaj ri poq nuʼj chke ri mebʼaʼ
Ri wchoch rex ri rkaʼybʼaal	#qum# Mi casa es de color v erde	                                                                                                  
Ataq kʼolik muuj chukaaj retal kʼchiʼ kpetik jabʼ	#qum# cuando hay nube en el cielo es seña que	Ataq kʼolik muuj chukaaj retal kʼchiʼ kpetik jabʼ
Ri raal kuch xiʼ qajik tiʼt njeel	#qum# Las crías de la marrana que cayero son hembras	Ri raal kuch xi' qajik ti't njeel
Ri nchuch xproj ri rtkuʼl	#qum# mi mamá lo quemó su paleta	
Ri rtibʼliil woy chetzʼini k rtijik	#qum# La comida es bien ssabrosa	Rtibʼliil woy chetzʼini kʼrtijik
Ataq xojelpoon chu ri ilbʼal qʼus rkaʼyxik ri tinmit	#qum# Cuando salimos al mirador el pueblo se mira bello	Ataq xojelpoon chu ri ilbʼal qʼus rkaʼyxik ri tinmit
Wu chʼmaay utz xtktij ri ajkʼlobʼ rech xtkʼobʼik kchoqʼaabʼ	#qum# El guisquil es bueno que	Wu maay z tktij ri ajkʼlobʼ rech xtkʼobʼik kchoqʼaabʼ
Ataq xkmol kiibʼ ri aloʼm xkbʼanken jun etzlaal chu ri qtikaʼ	#qum# Cuando se reunieron los	                                                                                                  
Ri wxqʼajlobʼ tarnuul chwij mi compañero viene atrás	#qum# Escuela	Ri wxqʼajlobʼ tarnuul chwij mi compañero viene atrás
Ri ixoq kirjokʼ ri skiil chu kaʼ	#qum# La mujer muele la pepita de ayote en la piedra de moler	                                                                                                  
Wu musmut utz chi qʼxom kʼuʼxaj	#qum# El ajenjo es bueno para el dolor de estómago	Wu musmut utz chi qʼxom kʼuʼxaj
Ri n tatanool nim ri retambʼal	#qum# Mi abuel o posee grandes conocimientos	
Don Jesus se puso la camisa al revés	#qum# Escama	Don Jesus se puso la camisa al revés
Ri toch ʼaʼ kirtij ri rwoch nuxtaʼ el jilguero c ome la fruta de la tuna	#qum# Pagar	                                                                                                  
Ri cheʼ pujpik sichaʼ kiryaʼ muʼj	#qum# el árbol es frondoso y da buena sombra	Ri cheʼ pujpik sichaʼ kiryaʼ muʼj
ataq xinbʼan ri wchoch xinbʼan jun jloom	#qum# Cuando construí mi casa tuve que hacer un préstamo	                                                                                                  
Ri saqtbʼiin jurjik wu rjey	#qum# La comadreja tiene la cola larga	                                                                                                  
Kʼa xaq et rchim wu chʼiichʼ xichaʼ qal xchʼij xelbʼik chu wu rujyubʼ	#qum# Por mucha carga el carro no aguantó salir en la subida	Kʼa xaq et rchim wu iich iich iich iich iich iich iich iich iich iich iich iich iich iich iich iich iich iich iich iich iich iich iich iich iich iich iich iich iich iich iich iich iich iich iich iich iich iich iich iich iich iich iich iich iich iich iich 
Ri rchak ri ixoq kirbʼan njeel qʼiij areʼ ri tʼisneem	#qum# El trabajo que hace la mujer todos los	Rchkrkrnrnrnrnrnrnrnrnrnrnrnrnrnrnrnrnrnrnrnrnrnrnrnrnrnrnrnrnrnrnrnrnrnrnrnrnrnrnrnrnrnrnrnrnrnrnrn
Wu jiiqʼ kiryaʼ che ri ajkʼalobʼ	#qum# La tosferina le da a los niños	Wu jiiqʼ kiryaʼ che ri ajkʼalobʼ
Ri aliit qʼus rkaʼyxik kukʼ ri ruwaj	#qum# La señorita se ve elegante con sus collares	Ri aliit qʼus rkaʼyxik kukʼri ruwaj
Ataq xkʼisik ri molbʼeem ri aloʼm xiʼ tikrook chu ktzʼulxik ri altom	#qum# Cuando terminó la	                                                                                                  
Wu chʼikaʼx xuqkee kchuknik chi siʼ	#qum# La chicharra de pino tambien se usa	Wu ikax xuqkee kchuknik chi si
En el techo de la casa hay dos agujeros	#qum# Semana	En el techo de la casa hay dos agujeros
Ri chaak xaq che rbʼ anik sic haʼ xqtzuntzaj	#qum# El trabajo quedó mal hecho por eso se	Ri chaak  right  that rbʼ anik sic ha  xqtzuntzaj
Aqʼabʼ xelbʼik ri achii chi rawxik ri chnooj	#qum# El hombre salió temprano a sembrar la	                                                                                                  
Xibʼal xibʼaliibʼ chu ri wiʼtnel	#qum# Hay mucho miedo al asesino Ciprés	Xibʼal xibʼaliibʼ chu ri wiʼtnel
X kʼatik ri rtzʼumil rqʼabʼ ri ixoq	#qum# a la señora se le quemó la piel de la mano	x kʼatik ri rtzʼumil rqʼabʼ ri ixoq
Jrubʼ rajlaal ri poq xeʼloq	#qum# Cuanto ascendió la cantidad del dinero	                                                                                                  
Qaqchee chik ri k ʼ yeej kumu xchupik ri rxoqʼjowil	#qum# Ya no hay venta porque se murió el dueño Bellota de arboles	Qaqchee chik ri kʼej kumu xchupik ri rxoqʼjowil
Ri ixoq xbʼeek chi rtaqxik qʼaʼtzuy praal cheʼ	#qum# La mujer fue a buscar hongo en la	                                                                                                  
Paqʼiij xoʼkik ri elqʼoom pjaay elqʼnel	#qum# De día ent raron los ladrones en la casa a robar	Paqʼiij xoʼkik ri elqʼoom pjaay elqʼnel
Ri qbʼey xsukʼbʼik kumu xqjnumsaj ri qchoqʼaabʼ	#qum# Nuestro camino se	                                                                                                  
Ataq xtzaqik ri ajkʼaal xelul kikʼ pirtzaʼm	#qum# C uando cayó el niño le salió sangre en la nariz	Ataq xtzaqik ri ajkʼaal xelul kikʼ pirtzaʼm
Ri wochbʼlaal areʼ jun naʼtbʼal qe	#qum# El retrato es algo que nos recuerda	Ri wochbʼalaal areʼ jun naʼtbʼal que
Ataq xi bʼal kqʼiiqʼ ri rwiʼ jaay ktzalbʼik	#qum# Cuando hay mucho aire el techo de la casa	Ataq xi bʼal kʼiiqʼ ri rwiʼ jaay ktzalbʼik
Ri raal chiij ktuʼnsxik kumu qal xpon rqʼij	#qum# La cria de la oveja lo amamantan porque	Ri raal chiij ktuʼnsxik kumu qal xpon rqʼij
Ri yaak xeʼrtij ri raa l akʼ	#qum# El gato de monte se comió todos los pollitos	R
Ri rkʼoʼxiil ubʼooy kchuknik chu awbʼal	#qum# La	Rkʼoʼxiil ubʼooy kʼchuknik chu awbʼal
Ri aliit qal kirkʼut saqsi tzʼeebʼ	#qum# A la muchach a no se le nota que es tartamuda	Ri aliit qal kirkʼut saqsi tzʼeebʼ
Ri achii xrubʼaaj ri musaat rukʼ ri ubʼ al	#qum# El hombre mató el venado con su	                                                                                                  
Ri rchiʼ jaay xpaqʼtjik rum ri rkabʼ rqan	#qum# la puerta de la casa se partió por el temblor	Rchi jaay xpaqtjik rum rkab rqan
Ri wnobʼ yuux ri raal	#qum# Mi hernana tiene gemelos	                                                                                                  
Ri tzʼiʼ xelul qʼaaqʼ chriij	#qum# Al perro le dio fiebre	Ri tzʼiʼ xelul qʼaaqʼ kriij
Ri tatyoox qal chik kirchʼij rjoʼxik ri rsomchiʼ	#qum# El anciano ya no aguanta afeitarse	                                                                                                  
Njeel ri ajchaak xeʼyoʼqook chu rpaqʼik ri uleew	#qum# Todos los trabajadores les pusieron a	Njeel ri ajchaak xeʼyoʼqook chu rpaqʼik ri uleew
Njeel ri ajchaak xeʼtobʼik chu rmolik ri abʼaj	#qum# T odos los trabajadores ayudaron para juntar la	Njeel ri ajchaak xeʼtobʼik chu rmolik ri abʼaj
Wu ulee w naʼl xtzʼaqik	#qum# La tierra se tiene que compactar bien	Wu ulee w naʼl xtzʼaqik
Ri wix kir qchʼuj ri paan	#qum# El gato le dió un mordisco al pan	                                                                                                  
Ataq xojelbʼik qonjeel x qtzʼap ijken ri rchiʼ jaay	#qum# Cerrado	Ataq xojelbʼik qonjeel x qtzʼap ijken ri rchiʼ jaay
Ri rchʼmeʼy ntatanool xq ʼajik	#qum# El bastó n de mi abuelo se quebró	Rmy ntatanool xq ʼajik
Ri abʼaʼ bʼantlik rukʼ saqkiiy	#qum# La hamaca está hecha de pita de mecate	Ri abʼaʼ bʼantlik rukʼ saqkiiy
¿Cuánto cuesta el sombrero que compró mi mamá en la plaza	#qum# ¿cuándo?	Cuánto cuesta el sombrero que compró mi mamá en la plaza
R i achii xelbʼik rukʼ ri rtzʼiʼ chu rtaqxik ri musaat	#qum# El hombre salió con su perro a cazar	                                                                                                  
Ri chʼooy xchʼulchʼaʼ ri ixiim	#qum# El ratón ensuscio todo el maíz fracción/ pedazo	Ri chʼooy xchʼulchʼa  ri ixiim
Njeel ri wnaq nim ri knoʼj sichaʼ utz ikʼolik	#qum# Toda la gente tienen buena ineligencia por eso están bien	Njeel ri wnaq nim ri                                                                                                
Ri nchuch xtzaltzaj ri poʼt ri xloqʼ kumu nuchʼ xkanaj chriij	#qum# Mi mamá tuvo que	                                                                                                  
Ri keqʼ kiryaʼ ptaq ri rqan swon	#qum# La Guayaba se da en los barrancos	Ri keqʼ kiryaʼ ptaq ri rqan swon
Ri kuch xkchʼulchʼaʼ ri kwoy	#qum# Los c erdos ensuciaron la comida	Ri kuch xkʼulchʼaʼ ri kwoy
Cuando oímos el río tumbar rápido corrimos	#qum# Bejuquillo	Cuando oímos el río tumbar rápido corrimos
Ajwiʼ xtpetik jabʼ rukʼ saqbʼuch	#qum# Hoy va llover con granizo	Ajwiʼ xtpetik jabʼ rukʼ saqbʼuch
Ri tzʼiʼ xkbʼalktij kiibʼ rukʼ ri sjiʼl	#qum# El perro se revolcaron con el coyote	                                                                                                  
Riliil riij ataq xkojwaʼljik xkojtyoxnik chu Ajaw	#qum# Es necesario cuando amanecemos debemos agradecer a Dios	Riliil riij ataq xkojwaʼljik xkojtyoxnik chu Ajaw
Kqʼoxwik ri nxkin	#qum# Me duele el oído	                                                                                                  
Ri ntzʼiʼ naqʼtlik kirtij iik	#qum# Mi perro está acostumbrado comer chile	Ri ntzʼiʼ naqʼtlik kirtij iik
Ptaq ri rqan swon kiryaʼ xibʼal ri chibʼaʼ	#qum# En los barrancos se da mucho el helecho	Ptaq ri rqan swon kiryaʼ xibʼal ri chibʼaʼ
R i ajtʼisnel xwiʼtxik kum ri elqʼoom	#qum# El sastre fue matado por los ladrones	
Ri ajtiij xbʼ iij chke ri ajtijnel kʼotz kixkʼ olaq	#qum# El maestro dice a los estudiantes que guarden	                                                                                                  
Ataq xeʼriqtjaq ri ixoq juplik bʼanmajken chre	#qum# Cuando le fueron a encontrar a la mujer la	                                                                                                  
La orina apesta mucho cuando hay mucho calor	#qum# Camarón	La orina apesta mucho cuando hay mucho calor
Nim ri kaʼy kbʼanik chu ri waʼktbʼal	#qum# Mucha diversión se hizo en el parque	Nim ri kaʼy kbʼanik chu ri waʼktbʼal
Ri yaaj utz xttijxik chke ri ajkʼlobʼ	#qum# El regaño es bueno enseñarles a los niños	                                                                                                  
Wu kuuk xkʼis ri a j chtijik	#qum# La ardilla se terminó de comer los elotes	Wu kuuk xkʼis ri a j chtijik
