input	reference	prediction
#qum# La esposa de don Jesus solo utiliza buena leña	wu rxqiil taʼ xuux xaq utz laj siʼ kchuknik chre	qum kʼiij ri rbʼal
#qum# Todo la arveja se	Njeel ri xkarawaʼn xpochʼik rech chenim xchaqʼjik	qum ri xbʼiʼxik ri rkaʼbʼal
#qum# En nuestro pueblo ya no se usa nuestro idioma	Pri qtinmit qal chik kchkunsxik ri qyolbʼaal	qum ri rwiʼ ri rkaʼy
#qum# El estudiante está aprendiendo como	Ri ajtijnel tjin kirtijuuj c hemo rchkunsxik ri suʼ	qum ri xtzʼoʼk ri rbʼaʼ
#qum# La mujer estaba abrazada por su marido	Ri ixoq tzʼulmaj rum ri rchjiil	qum ri kʼolik ri rqʼiij
#qum# Mañana van a sembrar con don Francisco	Rukʼ taʼ Francisco chwaʼq xtbʼanik awaʼn	qum ri xtʼiʼ ri rbʼal
#qum# Alrededor de la casa hay un cerco	Chwoch ri jaay kʼolik jun tzʼapiibʼ	qum kʼiij ri rkʼiij ri rkʼiʼj
#qum# Ataq	Los jóvene s todos los días juegan en el campo Perjuicio	qum ri rkʼaal ri ryaʼ xbʼaq ri rchʼal
#qum# Cuando murió mi mamá me quedé en la tristeza	Ataq xchupik ri nchuch xinkanajken pri bʼiis	qum ri xbʼeem ri kʼolik
#qum# la mujer se murió de la matriz	Ri ixoq xchupik rum wu rchuch rkʼuʼx	qum ri rkaʼ ri rkaʼyik
#qum# Entre tres días nos encontramos para platicar del	Oxej xtqriq qiibʼ chi ryolik ri chaak	qum ri rchʼ ri rkʼulul ri rqʼiij
#qum# A los niños no es bueno enseñarles a	Chke ri ajkʼ a lobʼ qal utz xtnaqʼsxik ri elqʼneem	qum rxbʼal ri rchʼiʼ ri ajkʼaʼ
#qum# La hoja de aliso es bueno para la broza	Ri rxaq limobʼ utz kchuknik chi ri qʼyees	qum ri rbʼan ri rbʼal ri rchʼiʼ
#qum# El caballo se cayó por mucha carga	Ri keej xtzaqik rum wu xaq et rchim	qum xbʼan ri rbʼeem
#qum# El bebé resbaló en la cascara de la fruta	Ri ajkʼal kjilpji k pri riij loʼn	qum utz xbʼanik
#qum# El señor le dejo toda la tierra a su nieto	Ri tatyoox xyaʼken njeel ri uleew chu ri rmon	qum ri ajkʼaʼl ri rbʼal
#qum# Los zapatos de la señorita les quedo flojo Jaula	Wu xjabʼ koʼl xiʼ kanajken pirqan wu aliit	qum ri kʼolik ri rkʼoʼl
#qum# La comadreja se terminó de comer las gallinas	Wu saqtbʼiin mixeʼrkʼis ri akʼ c htijik	qum ri rkʼal ri rkʼiij
#qum# Cuatro mesas grandes servirán para comer	Kji bʼ nmaq meex xkiʼchuknik rech weʼbʼal	qum ri xbʼal ri rkʼiij
#qum# Todos los lapiceros ya están divididos a los niños	Njeel ri tzʼibʼbʼal jachmaj chik chke ri ajkʼalobʼ	qum utz xbʼan ri rbʼan
#qum# La mata de aguacate se está secando por el	Ri rqan ooj tjin rchiqik rum wu tzrabʼ	qum ri ajkʼal ri rkʼaaj
#qum# Cuando bajamos a la orilla del río es muy	Ataq kojqajbʼik chchiʼ ri yaʼ xibʼal kliswik	qum xtzaʼ ri rbʼal
#qum# El hombre cuando	Ri achii ataq kirbʼsuj rbʼanik jun chaak, xtbsuj ri qʼiij chu rkʼisbʼaal	qum ri kchʼolik ri rkʼolik
#qum# La cara de la vaca se ve alargada	Tzʼajtzʼik rkaʼyxik ri rwoch ri waakx	qum xqʼiij ri rbʼanʼ
#qum# La araña come las moscas que están en la pared	Wu am kertij ri us ri ikʼoʼk chu xaan	qum ri rkaʼy ri rkʼaj ri rbʼanik ri rqʼiʼ
#qum# Kkanjik	Ataq kpetik nim jabʼ xibʼal ri senyabʼ	qum ri chʼiij ri rchʼal
#qum# mi papá tiene muchos parientes por eso no se mantiene en la casa	Ri wjow kʼiy richlaal sichaʼ qal kkʼuqbʼik chjaay	qumik ri rchʼiyik ri kʼiyik
#qum# Vejez	Ataq kpetik jabʼ njeel ri qʼoos krexbʼik	qum kiryaʼ xqʼiij ri rchʼiʼ ri wnaq
#qum# Todo el maíz se apolillo	Njeel ri ixiim xpokʼrik	qum kʼolik ri rqʼiij
#qum# por el daño que el hombre está	Ri uleew tjin rmeqʼik rum wu kʼex ri tjin kirbʼan ri achii chre	qum wu rkaʼj ri rbʼan
#qum# La masa salió quebrada	Ri qʼoor chqaam xelul	qum xbʼal ri rbʼaal
#qum# La botella se utiliza para guardar miel	Ri limeet kchuknik chi r kʼolik ri ryaʼl chʼoxiʼ	qum ri rkʼaʼj
#qum# Vamos todos para que nos atieden nuestra	Joʼ qonjeel rech xkojtaʼtjik che ri qajbʼeej	qum kʼoʼj ri rkʼoʼt
#qum# El río creció por eso se llevó toda la	Ri nimaya ʼ xkʼiyik sichaʼ xuʼrmaʼ njeel ri tikaʼ	qum kʼoʼyik ri rqʼoʼbʼal
#qum# El árbol es grandicimo por eso le pego el rayo	Jomom ri cheʼ sichaʼ xkʼeq rquljaay	qum ri xtzʼoʼj ri rbʼan
#qum# El frijol que se compra en la plaza lo	Ri knaqʼ ri kloqʼik pkʼeybʼal esmaj jun pajbʼal	qum ri ajkʼabʼ
#qum# Cuando cómo frijol me da ardor de pecho	Ataq kintij knaqʼ kiryaʼ qʼaʼteew chwa	qum ri rbʼal ri xchʼoʼj
#qum# Todas las frutas están rodajeada con cuchillo	Njeel wu loʼn jexmaj rukʼ qʼatbʼal	qum wu rbʼal ri rbʼaʼ
#qum# Ayer mi mamá compró hilo de varios colores	Iwir ri nchuch xloqʼ bʼatzʼ pkʼeybʼal jaljoj kkaʼybʼaal	qum riij xkʼiʼ ri rqʼiij
#qum# El ladrón fue arrastrado por las	Ri elqʼoom xqitxik kum ri wnaq xaq rum wu xrelqʼaaj jun keej	qum ri chaakʼ xbʼan ri rchʼiij
#qum# Las matas de maguey se están secando por la plaga	Ri rqan kiiy tjin rchiqik rum wu xoʼkik chkop txeʼ	qum kʼolik ri rchʼiyik ri rbʼal
#qum# Cuando se come un chompipe quiere mucho	Ataq ktijik jun chooj nim rkunaal kraaj	qum kʼolik ri chʼiʼl ri rkaʼy
#qum# Todo el techo de ,la casa gotea	Njeel ri rwiʼ jaay ktzʼujik	qum ri kʼolik
#qum# Quemar bien	El enfermo se empeoro porque salio bajo la lluvia	qum ri rbʼiʼl ri rqʼabʼ
#qum# La reun ion se realiza cada semana	Ri molbʼeem kbʼanik chwuqubʼ qʼiij	qum kʼolik ri rchʼabʼ
#qum# El árbol se le seco las hojas	Ri cheʼ xchiqik ri rxaq	qum ri xbʼoʼj riij ri rchʼiʼ
#qum# Con el doblador se hacen muñecas decoradas	Rukʼ wu joʼq keʼ bʼanik qʼus laj alaʼs	qum ri rchbʼal ri rbʼal
#qum# el coyote se comió l as once ovejas	Julajuuj chiij xeʼr tij ri sjiʼl	qum ri rbʼan riij ri rbʼal
#qum# El hombre se go lpeó la	Ri achii xkʼoxbʼsaj ri rjlom ataq xtzaqik rukʼ ri jochlan chʼiichʼ	qum ri rbʼeek ri rkʼaaq
#qum# El frujol blanco es delicioso comer en	Ri knaqʼ saqtbʼin chetzʼiʼnik rtijik pjkʼom iik	qum ri kʼolik ri rkʼolik
#qum# L avado	El cerdo ensució el maíz	qum ri rkʼoʼnik ri ajkʼabʼ
#qum# La mujer hace lasos con la	Ri ixoq kiʼrbʼan ri klobʼ rukʼ ri saqkiiy ri kirbʼan rukʼ ri choʼl	qum ri rkaʼbʼal ri rkʼaʼl
#qum# El ayote es bien rico pa ra comer	Chetzʼiʼnik rtijik ri qʼooqʼ	qum ri rkaʼbʼal ri rchʼaʼ
#qum# Cerca murió el marido de la mujer	Nqaaj waʼchiʼ xchupik ri rchjiil ri ixoq	qum rqʼiij ri rbʼal
#qum# Todo el tamal estaba comido por las ratas	Njeel ri subʼ tijmaj rum chʼoo y ataq xojsaqrik	qum kʼolik ri rqʼiyik
#qum# Arena	Ataq kiʼjikxik ri cheʼ ri uleew sbʼajbʼoj kkanjik	qum ri rbʼal ri xbʼanik ri rbʼal
#qum# El formón lo utiliza el carpintero	Ri tzʼqubʼ kchuknik chu ri jsol cheʼ	qum ri rkʼoʼj ri rtzʼiij
#qum# El conejo cuando hay buena luna sale a comer el frijol	Ri imul ataq kʼolik rqan iikʼ kelul chirtijik wu knaqʼ	qum ri rkʼaʼ ri rqʼiij
#qum# La mujer cuando mató a la gallina	Ri ixoq ataq xwiʼtaaj ri akʼ kʼa xlechʼpij ri rtzʼumil	qum ri rxbʼiij ri rchupnik
#qum# El documeto del terreno está ahumado	Ri rjujil uleew xsibʼrik wu riij	qum rtzʼiʼj ri wnaq
#qum# La flor de milpa lo come las chorchas	Ri tzʼtuj ktij tochʼaʼ chu kwoy	qum ri rkʼiij
#qum# Es necesario cuidar la naturaleza	Riliil riij xtloqʼxik ri uleew	qum kʼoxik ri rbʼal ri rkʼiij
#qum# La mayoría de los niños consumen mucha galguería	Ri knimalil ri ajkʼalobʼ ktij tzʼiʼlil	qum utzʼik rchʼaqʼ
#qum# Cuando entra el verano las vacas se ponen flacos	Ataq kokik saqʼiij yaax keʼlik ri waakx	qum ri rbʼal ri rchʼiʼ ri rchʼ
#qum# El niño se majó el dedo	Ri ajkʼaal xwochʼ wu rwiʼ rqʼabʼ	qum chik chik ri rkʼaʼ ri rbʼeʼ
#qum# Boca arriba	Ri nchuch xloqʼ ri paa kʼ pkʼeybʼal	qum ri xbʼal ri ajkʼaʼ
#qum# El niño no guantó porque se le regó agua	Ri ajkʼaal qal xchʼij kumu kʼten yaʼ xtixuul chriij	qum ri rkʼiij
#qum# La mariposa vuela entre las flores	Wu puʼt kxikʼnik chu taq ri kotzʼaj	qum ri kʼiij ri rbʼal
#qum# Todos los enfermos sanaron	Njeel ri ya abʼ mixuʼtzrik	qum wu rkʼaʼl xkʼuʼx
#qum# La milpa se secó porque le cayó hielo	Ri chnooj xchiqik kumu xqaaj teew chriij	qum ri achii rqʼik
#qum# El frijol amarillo da cuando se siembra	Ri xpley kiryaʼ ataq jnum kawxik rukʼ ri chnooj	qum xbʼiʼj ri xtzʼalwik ri rqʼiij
#qum# El agua tiene pureza	Ri yaʼ kʼolik rsaqiil	qum ri rqʼoʼqʼik chu rqʼoʼ
#qum# El techo de la casa de mi papá se ve de forma triangulo	Jutzʼjik rkaʼxik ri rwiʼ rchoch wjow	qum kirtij ri wnaq ri rchʼiʼ
#qum# Cuando el buhuo llega a	Ataq koʼqʼoʼk ri toltol chjaay labʼnel kʼolik chinaq xtkmik	qum ri xtzʼaʼ ri ajkʼalbʼal
#qum# La reunión de los estudiantes se hizo anteayer	Ri molbʼeem kech ri aj tijnel xbʼanik kabʼjiir	qum ri xbʼal ri rchʼiʼ
#qum# Mi mamá tiene sirvienta	Ri nchuch kʼolik rmkoom	qum wu rbʼaal chʼiʼbʼik
#qum# Los niños empezaron a llorar cuando perdieron	Ri ajkʼalobʼ xeʼoqʼik rum qal xkchʼak ri etzʼnim	qumilike.
#qum# Nuestro idioma es el Sipakapense	Ri qyolbʼaal areʼ ri Sipakapense	qum ri rqʼiij ri rchʼuʼj
#qum# Por un poco no alcanzo el fuego la otra casa	Xaq qiʼn chik qal xmaj qʼaaqʼ ri jun jaay chik	qum ri rkʼiʼt
#qum# El mal de ojo les afecta a los	Ri rbʼaqʼ rwoch wnaq kirbʼan kʼex chke ri ajkʼ a lobʼ	qum ri xbʼanik ri rkʼaʼl
#qum# No es bueno comer el sobrante al otro día	Qal utz xtqtij ri chʼqaap	qum xtzʼoʼj ri xtzʼajbʼal
#qum# A todas las	Chke njeel ri wnaq xbʼiʼxik ke qal xeʼlbʼik xkoybʼeej ke xkʼisik ri molbʼeem	qum ri rkʼalbʼal ri rkʼooq
#qum# Para la fiesta del pueblo todos damos la contribución Ri achii xkanajken	Rech ri nima qʼiij rech tinmit qonjeel qyaʼ ri kchuuj	qum ri rwiʼj ri rwiʼ ri rxbʼal
#qum# Todo el trabajo que se realizó estaba bien pensado por eso salió bien	Njeel ri chaak ri xbʼanik bʼusmaj riij sichaʼ utz xeʼloq	qum ri rkaʼy ri rkʼaaj
#qum# Por allá está la casa de mi hermana	Tukkilaʼ kʼolik r i rchoch ri wnobʼ	qum ri rkaʼyʼyik ri rchʼuʼ
#qum# Las flores que tiene sembrado mi mamá son de color rojo	Njeel ri kotzʼaj ri rawmaj ri nchucch keq rkaʼybʼaal	qum ri rbʼan ri rbʼanik ri rchʼal
#qum# Los trabajos de los antiguos ya no se encuentran	Ri kchak ri ojor wnaq qaqchee chik kiʼ riqt jik	qum ri rkʼaʼ ri rkʼiij
#qum# El granizo golpeo la milpa	Ri saqbʼuch xkʼoxbʼsaaj ri chno oj	qum ri xtzʼiʼtzʼik
#qum# Al niño le da estornudo	wu ajkʼaal kiryaʼ achyam chre	qum riij xbʼan ri rbʼanik ri rchʼiʼ
#qum# Codo	Pongale una cuña a la mesa	qum kʼolik rqʼiij
#qum# Salimos rápido por eso regresamos juntos	Cha niim xojelbʼ ik sichaʼ xojtz aljuul jnum	qumililqqʼʼqʼuʼj
#qum# El lápiz del estudiante se quebró	Ri rtzʼibʼbʼaal ri ajtijnel xqʼeptjik	qum ri ajkʼool
#qum# El cabello de la señorita está trensado con su	Ri rwiʼ ri aliit pochʼmaj rukʼ ri rxqʼap	qum ri xkʼooj ri rchbʼal
#qum# Ante el juez no se presentó el acusador	Chu ri qʼtal iil qal ri tzujnel xopnik	qum ri rbʼal ri rchʼiʼj ri rkʼaaj
#qum# C ama wu chʼaat bʼantlik rukʼ	Estaba mojado la camisa del hombre por eso le dio fiebre	qum xbʼal ri rkʼiij
#qum# El hom bre tiene bellos en el pecho	ri achii kʼolik rsmaal chu rkʼuʼx	qum xtzʼiʼj
#qum# Pizarron	La tabla es ancha	qum utz xbʼan ri xbʼan ri rkʼolik
#qum# El bebé gatea en el patio de la casa	Ri neʼ kchaknik pirqan jaay	qum xtzʼiʼ ri rbʼan
#qum# Hay personas que ya no se recuerda de	Kʼolik wnaq qal chik knaʼtaj ri kbʼanbʼaal chke	qum kʼolik rchʼiij
#qum# La señora ronca mucho cuando duerme	Wu ixoq kjororik wu rtzaʼm ataq kwrik	qum ri xbʼal ri rkʼolik ri chʼiij
#qum# La hoja de papel esta medio pegado	Ri rxaq juuj xaq qiʼn nakʼlook	qum kʼoʼyxik rqʼiij ri rbʼal
#qum# La gente cando existe entre ellos un problema se desprecian	Ri wnaq ataq kʼolik jun chʼoʼj chkxoʼl ketzlaj kiibʼ	qum wu xbʼanik ri rbʼeek ri rbʼan
#qum# El encendedor sirve para juntar el	Ri tʼiqbʼal kchuknik chu rnukʼik ri qʼaaqʼ	qum xtzʼajbʼik ri rkaʼybʼal
#qum# Cuando se junta	Ataq kmo lik ri knaqʼ kʼolik rkʼolbʼaal waʼchiʼ kyoʼqqaj wiʼ	qum ri rkʼalxik ri rkʼabʼ
#qum# Donde yo vivo es tierra caliente	Ri waʼchiʼ kʼo ri wchoch mqʼen jyubʼ	qum ri kʼolik ri kʼolik ri rbʼanik
#qum# C uando amanecemos el gallo canta	Ataq kojsaqrik ri tzeek koqʼik	qum ri rbʼal ri kchʼoʼqik
#qum# Todas las bancas son redondas	Njeel ri teem isetsik	qumʼ ri rxbʼal ri rtzʼiʼ
#qum# Cuando se tapisca la	Ataq kjachʼik ri jal xaq xeew ri rqan chnooj kkanjik	qum xbʼaal ri rkaʼbʼal
#qum# La masa salió fino en el molino	wu qʼoor kookʼ xelul pwu keʼbʼal	qum ri rkʼiʼtzʼik
#qum# Ri ixoq	Tráigalo	qum kʼolik ri rkʼool ri xqʼiij
#qum# La escuela cumplió el decimo sexto año de	Rwaqlaaj rjnobʼ ri tijbʼal xtzʼaqtik	qum wu rqʼoʼm ri rchaʼ
#qum# La fruta está medio ácido	Ri loʼn chʼomchʼoj rtijik	qum xbʼiʼj ri rkʼolik
#qum# Los zapatos de mi abuelo es de color negro	Ri rxjabʼ ntatanool qʼeq kkaʼybʼaal	qum ri rkʼaaq
#qum# Todas las hojas de papel se perforó	Njeel ri rxaq juuj xeʼ worik	qum ri rkʼool ri rbʼanik ri rbʼanik
#qum# La vaca es de mejilla gorda Extendido	Ri waakx lewlik wu rwoch	qum ri rkʼallik ri rkʼaʼ
#qum# Para espantar a los zanates sirve la onda de pita	Chu kxibʼxik ri chʼok kchuknik ri ixkeeqʼ	qum kʼolik ri rkʼolik ri rkʼiij
#qum# Todos los niños se dispersaron por el miedo	Njeel ri ajkʼalobʼ xiʼ tuknik rum xibʼal kiibʼ	qum ri kʼoʼqʼik ri rkʼabʼ
#qum# El hombre ya es viejo por eso no aguanta caminar	Ri achii riʼj chik sichaʼ qal kirchʼij kbʼinik	qum, i.e. i.e. i.e. i.e. i.e.e.e.e
#qum# Es necesario mostrar lo que se quiere	Riliil riij xtkʼutik ri kajwxik rbʼanik kukʼ ri wnaq	qum ri rbʼoʼl ri rkaʼj
#qum# La	Ri yuʼtz kʼebʼ muul xchuknik sichaʼ kamulbʼal rbʼiʼxik pqyolbʼaal	qum ri rbʼiʼj ri rkʼiij
#qum# La tortuguilla terminó de comer el frijol	Wu leem xkʼis ri knaqʼ	qum xtzʼiij xtzʼiij
#qum# L a haba se muele para pinol	Wu jaws kkeʼxik chu kʼej	qum kirbʼeem xtzʼiij
#qum# El trabajo está duro por eso no avanzaron los trabajadores	Wu chaak kow sichaʼ qal nim xkbʼan ri ajchaak	qum, so the workers have not gone forward
#qum# La olla grande es de boca grande	Wu nima xbʼoʼj leʼlik wu rchiʼ	qum wu rbʼal ri rkʼal ri rkaʼyxik ri rkʼoom
#qum# La abuela le duele su hueso	Ri nooy kiʼ qʼoxwik ri rbʼaqil	qum ri rkʼiʼj ri rkʼolik
#qum# Mi perro se murió despacio ór la vejez	Tkaal xkmik ri ntzʼiʼ rum riʼjaal	qum ri qʼolik ri rqʼiij
#qum# En la reunión llegaron solo dos mujeres	Pri molbʼeem xaq kʼeebʼ ixoq xoʼpnik	qum ri rkʼoʼj
#qum# Si hablamos con la verdad	Saqsi xkojyolwik chqatziij rtqriq kʼchiʼ ri utziil	qum xbʼanik ri rkʼal wu rbʼan
#qum# En el terreno hay montones de piedras	Pri uleew kʼolik kʼiy amluʼx abʼaj	qum ri rqʼiij
#qum# Para que no nos critiquen es bueno pagar la deuda	Rech qal xkojyolik, utz xttojik ri kʼaas	qum rkʼaʼ ri rqʼiij
#qum# Las aguas estancadas no es bueno	Ri tikʼlik yaʼ qal utz kumu kiʼ poqʼnik ri raal us	qum ri rkaʼbʼik ri rbʼal
#qum# El perro es travieso	Ri tzʼiʼ xwos	qum kʼolik ri rkʼolik
#qum# Existen personas que no creen en las imágenes	Kʼolik ri wnaq qal knmaj ri tyoox	qum, i. I. There are people who don't believe in images.
#qum# Que fecha nació mi hermano	Che rajlbʼaal rkʼosbʼik r i wtziik	qum wu rxchʼiʼj
#qum# M i mamá está enfermo de la tos	Ri nchuch yaabʼ rukʼ rqul	qum ri rkʼoʼj
#qum# la comadrona vive en el traingulo	Ri ajkuun tlaʼ kʼolik rchoch waʼchiʼ rbʼiʼ oxchʼuʼk	qum ri rxʼiʼj ri kʼoʼl
#qum# La gall inaza es bueno para abonar la siembra	Ri rchaq akʼ utz xtqajik chxeʼ ri tikaʼ	qum ri rkʼoʼxik ri rqʼabʼ
#qum# Cuando hay charcos de agua	Ataq kʼolik yaʼ tikʼlik xibʼal serat kiʼpoqʼnik	qum kirbʼik ri rkaʼyxik
#qum# El ladrón entró arriba por eso no se dio cuenta el perro	ajsik xokul ri elqʼoom sicha ʼ qal xnaʼ ri tzʼiʼ	qum. The thief went up there, so the dog didn't get his shit.
#qum# Cuando nacio el niño lo	Ataq xkʼosbʼik ri ajkʼaal rbʼaqʼtmaj riibʼ ri rkʼamaʼl rmuux pirqul	qum ri rqʼiij
#qum# El caballo tiene los ojos grandes	Ri keej bʼilbʼik wu rbʼaq rwoch	qum kʼaj ri rbʼaʼ ri rchʼiʼ
#qum# Barrendero	El cuarto lo han barrido	qum ri ajchʼbʼal ri ajkʼoʼn
#qum# Mi mamá puede hacer petate	Ri nchuch utz keʼrbʼan ri xkulbʼal	qum ri rkʼaʼtlik ri rwiʼy
#qum# La en voltura del papel está hecho de algodón	Ri pisbʼal ri juuj bʼantlik rukʼ miit	qum ri xtzʼiʼ ri rkʼiij
#qum# Todos los negocios están cerrados	Njeel ri kʼyeej itzʼaplik	qum kʼolik ri rbʼal
#qum# Dirrecion	Xsqarsxik ri riil ri achii se aclaró el delito del hombre	qum ri rqʼoʼqʼiij ri rchʼiʼ
#qum# En el camino se regó arena	Chpom ri bʼeey xtukxik poqlaaj	qum ri rwiʼkʼal ri rqʼoʼ
#qum# La ropa está mojada	Ri sʼaq tʼaq	qum ri rbʼaʼl xbʼeem
#qum# Cuando el perro olió las huellas del	Ataq xsiq ri tzʼiʼ ri qan chkop xtrambʼeej rech xwiʼtaaj	qum xtzʼoolbʼik ri rbʼanik
#qum# La señorita se le cayó la muela	Ri aliit xtzaqeel wu rkaʼ	qum ri rkʼaʼ xbʼan ri rkʼaaj
#qum# El perro lo hirió al hombre en la fosa poplítea	Ri tzʼiʼ xsok ri achii pirsmoqʼ	qum xtzʼiʼ ri rqʼiij
#qum# El consumo del cigarro daña el cerebro	Ri siikʼ kirbʼan kʼex chu ri tzantzqʼor	qum ri ajkʼaʼl ri rbʼal
#qum# Frijol	Ataq kpetik jabʼ wu kʼotzʼaj qʼus kkaʼyxik	qumik wu rkʼoʼn
#qum# Cuando está bien hecho el trabajo no es necesario repasarlo	Ataq utz bʼanmaj ri chaak qal chik ktzuntzxik	qum, i.e. i.e. i.e. i.e. i.e.e.e
#qum# El hombre que mató a la mujer es el culpable	Ri ajmaak areʼ ri achi i ri xwiʼt aaj ri ixoq	qumehehomehomehomehomehomehomehomehamohumamo
#qum# El pajon blanco sirve para elaborar canastas	Ri saqkʼim kchuknik chu kbʼanik xuʼk	qum ri tʼiichʼ ri rkʼolik
#qum# La casa es muy reducido por eso no	Latzʼ wu rpom jaay sichaʼ qal xiʼ kʼisook njeel ri wnaq	qumbʼal xbʼanik ri rbʼanik ri rkʼaʼ
#qum# Cunado cae las primeras lluvias salen	Ataq kqajik ri nabʼey rqan jabʼ keʼlul ri xkawalek	qum ri rchʼiʼ ri rkaʼj
#qum# El aguardiente causa daños a nuestro hígado	Ri xbʼaj kirbʼan kʼex chu ri qsosobʼ	qum ri rkaʼy ri chʼoom
#qum# Debajo de las piedras están las culebras	Xeʼ taq ri abʼaj kiʼkʼobʼik ri kmatz	qum ri rkaʼyxik ri rkʼolik
#qum# La siembra crece con el calor del sol	Ri tikaʼ kkʼiyik rum ri rmeqʼnal ri qʼiij	qum ri chʼiʼtʼik
#qum# Entre seis meses va parir la vaca	Waqiibʼ iikʼ chi k xtqajik raal wu wakx	qum ri rbʼaaj ri rnaqʼ xtʼiʼ
#qum# Esto lo dijo un chismoso	Jun mlol ylooj xb ʼiʼnik re waʼ	qum ri xkʼalbʼal ri rkaʼbʼal
#qum# La nuera se le puso a	Ri albʼatz xyoʼqook chu rqirxik ri rwoch ixiim	qum xbʼeek
#qum# En la cima del cerro fuimos hacer la ceremonia maya	Pirwiʼ ri jyubʼ xeʼqbʼnaʼ ri chʼabʼal maaya	qum ri achii xbʼan ri rkʼuʼj
#qum# El muchacho se cortó el pie con el machete	R i alaabʼ xtochʼ ri rqan rukʼ ri tochʼbʼal	qum ri ixoqʼ ri rchupik
#qum# Los ladrones de noche robaron la vaca de mi papá	Ri elqʼoom chaqʼabʼ xkelqʼaaj ri rwaakx wjow	qum ri rkʼaʼl ri raʼ
#qum# la señora siempre padece del catarro	Ri nanyoox xaq kyabʼabʼ ik rum wu re tzaʼm	qum kʼolik ri kʼolik
#qum# Mi hermano construyó su casa retirado a la mia	Najeʼl xbʼan ri wtziik ri rchoch	qum kʼolik
#qum# La señorita tiene los pechos grandes	Ri aliit nmaq wu riim	qumik ri rkaʼyik ri rchaʼ
#qum# El buche de la gallina se llenó con granos de maíz	Ri rbʼuch akʼ xnojik rukʼ rwoch ixiim	qum ri xqʼiij ri rchʼal ri rchʼiʼ
#qum# En mi pueblo hay pocos ladinos	Pri ntinmit qal kʼiy moos ikʼolik	qum ri kʼolik ri rqʼiij
#qum# El cuero se secó en el sol	Ri tzʼuum xchiqik chu qʼiij	qum wu rkʼiij ri rchʼiʼ
#qum# El niño está enfermo por eso no puede reir	Ri ajkʼaal yaabʼ sichaʼ qal ktzeʼnik	qum ri ajkʼabʼal kʼolik ri rkʼaʼ
#qum# La mosca es un animal malo porque contamina lo	Wu us qal utz laj chkop kir chʼulchʼaʼ ri che ri qtij	qum utz ri rbʼal
#qum# Cuando los niños se levantan todos cantan	Ataq kiʼ waʼljik ri ajkʼalobʼ konjeel keʼ bʼixnik	qum ri rqʼiij ri rchʼuum
#qum# A los niños es necesario enseñarles a saludar	Chke ri ajkʼalobʼ riliil rij xkeʼtijxik rech xkeʼqʼajlaʼnik	qum xbʼal ri ajbʼal
#qum# El escritor escribió varios cuentos en el	Ri ajtzʼibʼnel xeʼrtzʼibʼaaj kʼiy q taʼ pqyolbʼaal	qum wu rkaʼy
#qum# La señora preguntó cuanto vale la gallina	Ri ixoq xtzʼonjok jrubʼ rjil wu akʼ	qum kʼolik ri rkaʼyxik ri rqʼolik
#qum# El lazo se estiro porque se mojó	wu klobʼ xyuqpjik ataq xchnaʼnik	qum riij xkʼabʼanik ri rqʼaal
#qum# Sapo	La laga rtija sale cuando hay sol	qumpaʼ ri rchoʼ riʼ riij riij
#qum# El trozo ya está seco	Ri xaʼk chqiʼj chik	qum ri rkʼiij ri rbʼaal
#qum# Para curar la tos es bueno el jengibre	Ri xenxipr utz chi kunbʼal ri qulaj	qum xtzʼool ri rbʼaqik
#qum# El laso lo hacen torcer con malacates	Ri klobʼ ktumxik rukʼ xweelx	qum ri chʼiij
#qum# El agua de la	Ri ryaʼl tzmeʼy utz xtqum jun ixoq rech q al ri raal xtokʼwik	qum ri ajkʼabʼ ri rkʼalbʼanik
#qum# El borracho cuando cayó quedó de boca arriba	Ri qʼabʼreel pakʼlik xkanjik ataq xtzaqik	qum ri rbʼalxik ri rchʼal
#qum# El hombre cuando se fue a traer leña no llevó su mecapal	Ri achii ataq xbʼeek chu rkʼamik siʼ qal xkʼambʼik ri rptem	qum ri ajkʼabʼ ri rchʼabʼ
#qum# El año pasado se fundó el caserío	Junbʼer xkʼuqbʼsxik ri rwiʼ rqʼabʼ tinmit	qum xtʼal ri rchʼiʼ
#qum# Rech ri tinmit	Njeel jnobʼ kbʼanik ri nimaqʼʼij	qum ri rqʼolik ri rkaʼyxik
#qum# A la mujer le dió vahído	Ri ixoq xpe saqtqoj chriij	qum ri kʼolik ri rkʼolik
#qum# El muchacho se cayó y se quebró la mano	Ri alaabʼ xtzaqik xqʼoch wu rqʼabʼ	qum rkʼuʼj riij ri rchʼoʼj
#qum# Mi hermano apuntaló su casa	Ri wtziik xaq xchʼutij ri rchoch	qum ri rkʼoʼy ri rkʼabʼ
#qum# al otro lado del rio está la casa de Elena	Chqʼayaʼpon ri yaʼ kʼolik rchoch ri Leʼn	qum xbʼeek ri rkʼiij
#qum# La cola de gallo sirve para adornar	wu ekʼaʼ kchuknik chu wiqbʼal	qum ata ataq kʼolik ri rchʼiʼ
#qum# Dolor	Iwir xintzaqken ri qʼaxbʼal chaʼnbʼal ayer perdí el teléfono	qum, i.e.
#qum# Mi tío tiene dos hijastras	Ri wkaan kʼolik kʼeebʼ rmyaʼlbʼaal	qumq qʼoʼjqʼik ri rqʼichʼ riichʼ
#qum# Palo blanco	Ri saqʼuul xaq tqʼaaj kiryaʼ wiʼ, El plátano solo se da en la costa	qum ri rkʼal ri rkʼiʼ
#qum# Ayer en la tarde estuvimos en una reunión	Iwir xqʼeq xojkʼobʼik pjun molbʼeem	qum ri xkʼiij ri rkʼoom
#qum# El niño se debe agarrar de la mano	Ri ajkʼaal riliil rij kyuqxik chu ri rqʼabʼ	qum ri xbʼal ri rkʼaʼbʼal
#qum# El maestro lo mando a serntar al abuelo en la silla	Ri ajtiij xkʼuqbʼaʼ ri tatanool chu teem	qum ri rkʼaʼl ri rkaʼyik
#qum# Todos tomamos atol	Qonjeel qqum qʼoor	qum xbʼanik ri rkaʼaj
#qum# Dentro de un año	A qué hora nos vamos al entierro	qumqqqqqqqqqqqqqqqqqqqqqqqqqqqqqqqqqqqqqqqqqqqqqqqqqqqqqqqqqqqqqqqqqqqqqqqqqqqqqqqqqqqqqqqqqqqqqqqqqqqqqqqqqqqqqqqqqqqqqqqqqqqqqqqqqqqqqqqqqqqqqqqqqqqqqqqqqqqqqqqqqqqqqqqqqqqqqqqqqqqqqqqqqqqqqqqqqqqqqq
#qum# Las frutas se ven grandes	Wu loʼn nmaq kkaʼyxik	qum ri rxbʼaal
#qum# El cerdo tiene mucho piojo	Ri kuch xibʼal squkʼ chriij	qum xbʼalxik ri ajkʼeem
#qum# El bebé no aguantó la fiebre	Ri lochʼ qal xchʼij ri qʼaaqʼ xelul chriij	qum rbʼal ri rbʼan
#qum# la señorita cuando viaja en carro le da vómito	Ri aliit ataq kbʼeek pchʼiichʼ kiryaʼ xaʼw chre	qum ri ajkʼabʼ xtzʼalxik
#qum# La gente pelean por el agua	Ri winaq keʼchʼoʼ jnik chrij ri yaʼ	qum ri rbʼaaj
#qum# Mi papá todos los días se mantiene ocupado	Ri wjow njeel qʼiij qal jamlik	qumqʼik riʼ riʼ riʼ riij
#qum# En frente la iglesia	Chu wu jaay rech chʼabʼal kʼolik kʼeebʼ mulmik uleew	qum ri rkʼal ri rchʼabʼ
#qum# el árbol quedó atravesado en el camino	Ri cheʼ qʼeʼlik xk anjik pri bʼeey	qum ri rbʼaal ri rkʼiybʼal
#qum# El color de la oveja es medio negro	Ri chiij qʼeqqʼoj rkaʼybʼaal	qum kʼallik ri rkaʼyxik
#qum# Es necesario cuando tomamos el agua	Riliil riij ataq xtqum ri yaʼ nabʼeey xtrqowsxik	qum, i.e. i.e. i.e. i.e.e. i.e. i.e.e.e.e
#qum# La fruta se endulza con los rayos del sol	Ri rwoch tikaʼ kkiʼyrik rum wu rtun qʼiij	qum kʼiʼl ri rkaʼj ri rchʼaʼ
#qum# La fruta del nopal tiene mucha espina	Ri rwoch nuxtaʼ xibʼal rkʼixil	qum ri rkʼiij ri rbʼal
#qum# La señorita c uida al bebé	Ri aliit kiryqʼuj ri ajkʼaal	qum xbʼalxik ri rbʼanik
#qum# En el agua encharcada hay mucho zancudo	Chpom ri yaʼ piʼlik xibʼal xaʼn	qum ri rbʼanbʼal ri rxʼaqʼal
#qum# El perro ronronea cuando mira su	Ri tzʼiʼ ktzʼuʼynjik ataq kirkaʼyij wu rxoqʼjowil	qum ri xkʼaʼ ri rkaʼyxik
#qum# Cuando llegamos ya estaba abierto la	Ataq xojopnik jaqlik chik ri rchiʼ jaay jroq koʼkik elqʼoom	qum ri ajkʼuʼl ri rkʼoʼl
#qum# El niño se enfermo de dearrea	Ri ajkʼaal xyabʼrik rukʼ xjir	qum ri rkʼoʼbʼik ri rtzʼiʼ
#qum# Las hormigas comen la migaja de tortilla	Ri snik ktij ri rxiʼl leej	qum ri rqʼaal xtzʼiij
#qum# Los que engalanan la fiesta son las bellas mujeres	Ri kiʼ wiqnik ri nima qʼiij areʼ ri qʼus laj taq ixoq	qum ri xbʼeʼl ri rchaʼ
#qum# El durazno está desabrido	Ri traas spoqʼpoj rtijik	qumik ri xbʼajik ri ri rbʼal
#qum# La sábila es bueno para las quebraduras	Ri wiqabʼaaq kchuknik chu ri qʼajaʼ	qum riij xbʼeek
#qum# El bebé ya no pudo mamar porque se le	Ri ajkʼa al qal chik xtuʼnik rum wu xsopjik wu rqul	qum ri rkʼoʼn ri rkʼooq
#qum# Todos los	Qonjeel wu ojkʼolik chu rwoch paxil nkareʼ xaq jnum ri qbʼanbʼaal	qum ri rkaʼbʼanik
#qum# El m uchacho mató una ardilla con su onda	Ri alaabʼ xwiʼtaj jun kuuk rukʼ ri r chʼaabʼ	qum kirbʼal ri rtijnik ri rqʼoʼ
#qum# La rodilla de mi hermano se quebró cuando le cayó un trozo encima	Ri rchʼeek wtziik xqʼajik ataq xtzaquul jun xaʼk chriij	qum ri rbʼalʼal kʼolik ri rchʼuʼl
#qum# El dor mitorio es limpio	Ri wurbʼal kchʼajchʼtik	qum riij xkʼolik ri rkʼooʼ
#qum# El carro se fue directo al barranco	Ri chʼiichʼ suukʼ xbʼeek pswon	qum ri rchʼul ri rchʼul ri chʼool
#qum# En el terreno hay varios muros	chpom ri uleew kʼiy kʼulbʼat ikʼolik	qum ri raal ri rqʼabʼ xbʼanik ri rbʼanik
#qum# Una vez se dice que lo más importante es el respeto	Jumul xtbʼiʼxik ke ri qatz riliil riij areʼ ri nimneem	qum, sexi, sexi, sexi, sexi
#qum# El caldo salió medio salado	Ri ryaʼl iik tzeytzoj xelik	qum ri rbʼoʼj
#qum# Cuando caminamos mucho los pies nos	Ataq kojbʼinik nim tʼuus keʼlik ri qqan	qum ri rchʼik ri rchʼiichʼ
#qum# Cuando desaté la pita es fácil arrollar en un olote	Ataq xinsol ri kʼaam xinbʼotzʼ chrij jun piʼq	qum ri chaʼ ri ajkʼal
#qum# El chichicaste tiene mucha espina	Xibʼal rkʼixil ri yeel	qum ri xtzʼajik ri rbʼal
#qum# Para la fiesta trabajaron dos recepcionista	Pri nimaqʼiij xeʼchuknik kʼeebʼ ulanel	qum ri rkʼoʼj
#qum# A ellos les dieron el dinero para hacer la fiesta	Chke xyoʼqik njeel ri poq chi rbʼanik ri nimaqʼiij	qum.
#qum# Mi sobrino es un buen hombre	Ri wkaaqʼ areʼ jun utz laj achii	qum ri xtzʼoʼn
#qum# El cuero estaá extendido en el suelo	Ri tzʼuu m likʼmaj rwoch chu uleew	qum ri kʼolik ri rqʼabʼ
#qum# Por estar	Rum wu qal tzʼqaat ri rpajbʼaal ri ajkʼeynel sichaʼ xbʼeek pcheʼ	qum riij xtʼaʼ ri rkʼal
#qum# El atol no se pudo tomar	Ri qʼoor qal xqumik kʼten xtewrsxik tekʼchi xjachik	qum ri rkʼaʼn
#qum# Temascal	Ri wakx jurjik ri raaqʼ La vaca tiene la lengua larga	qum ri kʼolik ri rbʼal ri rchʼiʼ
#qum# No es bueno prestar algo a alguien porque se adueña	Qal utz xtqyaʼ jun che chqoom ri wnaq kʼa krechbʼeej	qumehelqʼiʼj
#qum# El cuero que tiene el sentadero se	Ri tzʼuum ri kʼaʼn chu ri kʼuqulbʼal mixjarik	qum ri xbʼeek ri rxʼoʼn
#qum# El hombre cuando siembra busca	Ri achii ataq kir bʼan ri awaʼn kertaqiij ajchaak chu rtoxik	qum wu rchʼiʼj
#qum# La gallina clueca se mur ió	Xkmik ri tʼuq laj akʼ	qum ri rkʼallik ri rqʼabʼ
#qum# Mi mamá compró una servilleta	Ri nchuch xloqʼ jun suʼbʼal qʼabʼ	qum ri rbʼanik rqʼabʼ ri rchʼiʼ
#qum# es bueno regalar dinero pero a los huérfanos	Utz xtqsipaj ri poq nuʼj chke ri mebʼaʼ	qum riij chʼoʼn
#qum# Mi casa es de color v erde	Ri wchoch rex ri rkaʼybʼaal	qum ri xbʼal ri rchʼiʼ
#qum# cuando hay nube en el cielo es seña que	Ataq kʼolik muuj chukaaj retal kʼchiʼ kpetik jabʼ	qum ri xtʼaqik ri rbʼanik ri rchʼiij
#qum# Las crías de la marrana que cayero son hembras	Ri raal kuch xiʼ qajik tiʼt njeel	qum riij xtbʼaqbʼal ri rbʼal
#qum# mi mamá lo quemó su paleta	Ri nchuch xproj ri rtkuʼl	qumbʼ ri rkʼaʼj
#qum# La comida es bien ssabrosa	Ri rtibʼliil woy chetzʼini k rtijik	qum ri xkʼolik ri rqʼiij
#qum# Cuando salimos al mirador el pueblo se mira bello	Ataq xojelpoon chu ri ilbʼal qʼus rkaʼyxik ri tinmit	qum ri rtzʼiʼ
#qum# El guisquil es bueno que	Wu chʼmaay utz xtktij ri ajkʼlobʼ rech xtkʼobʼik kchoqʼaabʼ	qum wu rkʼooqʼik
#qum# Cuando se reunieron los	Ataq xkmol kiibʼ ri aloʼm xkbʼanken jun etzlaal chu ri qtikaʼ	qum ri rqʼoʼqʼik ri rqʼiij
#qum# Escuela	Ri wxqʼajlobʼ tarnuul chwij mi compañero viene atrás	qum ri rkaʼtzʼal ri rbʼal
#qum# La mujer muele la pepita de ayote en la piedra de moler	Ri ixoq kirjokʼ ri skiil chu kaʼ	qum ri xkʼaʼbʼal ri rbʼal
#qum# El ajenjo es bueno para el dolor de estómago	Wu musmut utz chi qʼxom kʼuʼxaj	qum rkʼal ri rkʼaaj
#qum# Mi abuel o posee grandes conocimientos	Ri n tatanool nim ri retambʼal	qum ri rkaʼbʼaʼ
#qum# Escama	Don Jesus se puso la camisa al revés	"qum: ""Treco de la cruz es muy fuerte"""
#qum# Pagar	Ri toch ʼaʼ kirtij ri rwoch nuxtaʼ el jilguero c ome la fruta de la tuna	qumizer (s)
#qum# el árbol es frondoso y da buena sombra	Ri cheʼ pujpik sichaʼ kiryaʼ muʼj	qum ri rbʼanik ri rchʼuʼ
#qum# Cuando construí mi casa tuve que hacer un préstamo	ataq xinbʼan ri wchoch xinbʼan jun jloom	qum, i had to make a loan
#qum# La comadreja tiene la cola larga	Ri saqtbʼiin jurjik wu rjey	qum ri ajbʼaal
#qum# Por mucha carga el carro no aguantó salir en la subida	Kʼa xaq et rchim wu chʼiichʼ xichaʼ qal xchʼij xelbʼik chu wu rujyubʼ	qum ri kʼolik ri rkaʼyxik ri rkaʼyxik
#qum# El trabajo que hace la mujer todos los	Ri rchak ri ixoq kirbʼan njeel qʼiij areʼ ri tʼisneem	qum kʼolik ri rkʼiij
#qum# La tosferina le da a los niños	Wu jiiqʼ kiryaʼ che ri ajkʼalobʼ	qum ri chaak rkʼiʼj
#qum# La señorita se ve elegante con sus collares	Ri aliit qʼus rkaʼyxik kukʼ ri ruwaj	qum kʼiij ri rqʼoʼqʼik
#qum# Cuando terminó la	Ataq xkʼisik ri molbʼeem ri aloʼm xiʼ tikrook chu ktzʼulxik ri altom	qum ri rkʼiʼj xtzʼaʼl
#qum# La chicharra de pino tambien se usa	Wu chʼikaʼx xuqkee kchuknik chi siʼ	qum xbʼiʼj ri xbʼanik ri rkʼajbʼ
#qum# Semana	En el techo de la casa hay dos agujeros	qum rkʼaʼ ri rbʼaʼ ri rkʼolik
#qum# El trabajo quedó mal hecho por eso se	Ri chaak xaq che rbʼ anik sic haʼ xqtzuntzaj	qum xbʼeek ri rkaʼbʼal
#qum# El hombre salió temprano a sembrar la	Aqʼabʼ xelbʼik ri achii chi rawxik ri chnooj	qum ri xtzʼulik
#qum# Hay mucho miedo al asesino Ciprés	Xibʼal xibʼaliibʼ chu ri wiʼtnel	qum ri tziʼl ri rkʼoom
#qum# a la señora se le quemó la piel de la mano	X kʼatik ri rtzʼumil rqʼabʼ ri ixoq	qum ri rkaʼy ri rkaʼyxik
#qum# Cuanto ascendió la cantidad del dinero	Jrubʼ rajlaal ri poq xeʼloq	qum ri rbʼal ri rbʼal
#qum# Ya no hay venta porque se murió el dueño Bellota de arboles	Qaqchee chik ri k ʼ yeej kumu xchupik ri rxoqʼjowil	qum xbʼeem ri ajkʼaal
#qum# La mujer fue a buscar hongo en la	Ri ixoq xbʼeek chi rtaqxik qʼaʼtzuy praal cheʼ	qum wu kʼolik ri rtzʼoʼl
#qum# De día ent raron los ladrones en la casa a robar	Paqʼiij xoʼkik ri elqʼoom pjaay elqʼnel	qum.
#qum# Nuestro camino se	Ri qbʼey xsukʼbʼik kumu xqjnumsaj ri qchoqʼaabʼ	qum kʼiij ri rkaʼxik
#qum# C uando cayó el niño le salió sangre en la nariz	Ataq xtzaqik ri ajkʼaal xelul kikʼ pirtzaʼm	qum. I was a little kid.
#qum# El retrato es algo que nos recuerda	Ri wochbʼlaal areʼ jun naʼtbʼal qe	qum ri aliit
#qum# Cuando hay mucho aire el techo de la casa	Ataq xi bʼal kqʼiiqʼ ri rwiʼ jaay ktzalbʼik	qum kʼolik ri rbʼal
#qum# La cria de la oveja lo amamantan porque	Ri raal chiij ktuʼnsxik kumu qal xpon rqʼij	qum xtzʼaʼnik ri rkaʼy
#qum# El gato de monte se comió todos los pollitos	Ri yaak xeʼrtij ri raa l akʼ	qum xbʼiʼj ri xkʼeem ri rbʼanik
#qum# La	Ri rkʼoʼxiil ubʼooy kchuknik chu awbʼal	qum kʼallik ri ajkʼal
#qum# A la muchach a no se le nota que es tartamuda	Ri aliit qal kirkʼut saqsi tzʼeebʼ	qum ri xbʼal ri rbʼal
#qum# El hombre mató el venado con su	Ri achii xrubʼaaj ri musaat rukʼ ri ubʼ al	qum wu rchʼiʼj ri rchʼiʼj
#qum# la puerta de la casa se partió por el temblor	Ri rchiʼ jaay xpaqʼtjik rum ri rkabʼ rqan	qum kʼolik ri rkʼolik
#qum# Mi hernana tiene gemelos	Ri wnobʼ yuux ri raal	qum ri xbʼal ri rkʼolik ri rqʼal
#qum# Al perro le dio fiebre	Ri tzʼiʼ xelul qʼaaqʼ chriij	qum xbʼal riij xkʼuʼj
#qum# El anciano ya no aguanta afeitarse	Ri tatyoox qal chik kirchʼij rjoʼxik ri rsomchiʼ	qum xbʼan ri rkʼiij
#qum# Todos los trabajadores les pusieron a	Njeel ri ajchaak xeʼyoʼqook chu rpaqʼik ri uleew	qum ri rbʼaʼl ri rkaʼbʼal
#qum# T odos los trabajadores ayudaron para juntar la	Njeel ri ajchaak xeʼtobʼik chu rmolik ri abʼaj	qum ri rbʼaʼbʼal ri rbʼaal
#qum# La tierra se tiene que compactar bien	Wu ulee w naʼl xtzʼaqik	qum ri rkʼoʼj ri rtiʼ
#qum# El gato le dió un mordisco al pan	Ri wix kir qchʼuj ri paan	qum ri rxbʼiij
#qum# Cerrado	Ataq xojelbʼik qonjeel x qtzʼap ijken ri rchiʼ jaay	qum ri rbʼal riij xtzʼoom
#qum# El bastó n de mi abuelo se quebró	Ri rchʼmeʼy ntatanool xq ʼajik	qum wu rjoʼqʼyxik
#qum# La hamaca está hecha de pita de mecate	Ri abʼaʼ bʼantlik rukʼ saqkiiy	qum ri xtzʼiʼj
#qum# ¿cuándo?	¿Cuánto cuesta el sombrero que compró mi mamá en la plaza	qum riij xtzʼaqik
#qum# El hombre salió con su perro a cazar	R i achii xelbʼik rukʼ ri rtzʼiʼ chu rtaqxik ri musaat	qum ri rkaʼ ri rkaʼyukʼ
#qum# El ratón ensuscio todo el maíz fracción/ pedazo	Ri chʼooy xchʼulchʼaʼ ri ixiim	qum xbʼeek ri rqʼiij ri rbʼal
#qum# Toda la gente tienen buena ineligencia por eso están bien	Njeel ri wnaq nim ri knoʼj sichaʼ utz ikʼolik	qum wu rbʼabʼal ri rchʼal
#qum# Mi mamá tuvo que	Ri nchuch xtzaltzaj ri poʼt ri xloqʼ kumu nuchʼ xkanaj chriij	qum utzʼiibʼ xbʼanik
#qum# La Guayaba se da en los barrancos	Ri keqʼ kiryaʼ ptaq ri rqan swon	qum ri kʼolik ri rchʼiʼ ri rchʼiʼ
#qum# Los c erdos ensuciaron la comida	Ri kuch xkchʼulchʼaʼ ri kwoy	qum ri rkaʼbʼaal ri rchʼiʼ
#qum# Bejuquillo	Cuando oímos el río tumbar rápido corrimos	qum ri xtzʼiʼm ri rchʼiʼ
#qum# Hoy va llover con granizo	Ajwiʼ xtpetik jabʼ rukʼ saqbʼuch	qum wu wu rkʼaʼj
#qum# El perro se revolcaron con el coyote	Ri tzʼiʼ xkbʼalktij kiibʼ rukʼ ri sjiʼl	qum ri rkʼaaq
#qum# Es necesario cuando amanecemos debemos agradecer a Dios	Riliil riij ataq xkojwaʼljik xkojtyoxnik chu Ajaw	qum ata
#qum# Me duele el oído	Kqʼoxwik ri nxkin	qum ri rkaʼyxik ri rkʼiij
#qum# Mi perro está acostumbrado comer chile	Ri ntzʼiʼ naqʼtlik kirtij iik	qum kʼaaq xbʼanik ri rqʼiij
#qum# En los barrancos se da mucho el helecho	Ptaq ri rqan swon kiryaʼ xibʼal ri chibʼaʼ	qum ri kʼoʼl ri rkʼolik
#qum# El sastre fue matado por los ladrones	R i ajtʼisnel xwiʼtxik kum ri elqʼoom	qum ri rkaʼtzʼiim
#qum# El maestro dice a los estudiantes que guarden	Ri ajtiij xbʼ iij chke ri ajtijnel kʼotz kixkʼ olaq	qum ri rtijnik ri rqʼiij
#qum# Cuando le fueron a encontrar a la mujer la	Ataq xeʼriqtjaq ri ixoq juplik bʼanmajken chre	qum ri rchʼaal ri rtzʼoʼ
#qum# Camarón	La orina apesta mucho cuando hay mucho calor	qum ri xkʼabʼal
#qum# Mucha diversión se hizo en el parque	Nim ri kaʼy kbʼanik chu ri waʼktbʼal	qum ri rkaʼyxik ri rkaʼy
#qum# El regaño es bueno enseñarles a los niños	Ri yaaj utz xttijxik chke ri ajkʼlobʼ	qum ri rkʼaʼbʼal
#qum# La ardilla se terminó de comer los elotes	Wu kuuk xkʼis ri a j chtijik	qum ri xbʼal ri rxʼaqʼ ri rbʼal
