input	reference	prediction
#qum# La esposa de don Jesus solo utiliza buena leña	wu rxqiil taʼ xuux xaq utz laj siʼ kchuknik chre	qum, and the other side is a right-hander than a right-hander.
#qum# Todo la arveja se	Njeel ri xkarawaʼn xpochʼik rech chenim xchaqʼjik	qum's all that is left of the earth.
#qum# En nuestro pueblo ya no se usa nuestro idioma	Pri qtinmit qal chik kchkunsxik ri qyolbʼaal	qum in our village our language is no longer spoken
#qum# El estudiante está aprendiendo como	Ri ajtijnel tjin kirtijuuj c hemo rchkunsxik ri suʼ	qumate, and the student learns how to
#qum# La mujer estaba abrazada por su marido	Ri ixoq tzʼulmaj rum ri rchjiil	qum, the woman was in the arms of her husband.
#qum# Mañana van a sembrar con don Francisco	Rukʼ taʼ Francisco chwaʼq xtbʼanik awaʼn	qum, and they will be seed with the seed of the Lord tomorrow with the seed of the
#qum# Alrededor de la casa hay un cerco	Chwoch ri jaay kʼolik jun tzʼapiibʼ	qum the house is a siege
#qum# Ataq	Los jóvene s todos los días juegan en el campo Perjuicio	qum Ataq qʼoʼlqʼik ri ri qʼoʼlqʼik
#qum# Cuando murió mi mamá me quedé en la tristeza	Ataq xchupik ri nchuch xinkanajken pri bʼiis	qum when my mother died.
#qum# la mujer se murió de la matriz	Ri ixoq xchupik rum wu rchuch rkʼuʼx	qum's death from the woman's womb.
#qum# Entre tres días nos encontramos para platicar del	Oxej xtqriq qiibʼ chi ryolik ri chaak	qum in three days to discuss the
#qum# A los niños no es bueno enseñarles a	Chke ri ajkʼ a lobʼ qal utz xtnaqʼsxik ri elqʼneem	qumile the way, and the children are not good at teaching, nor at
#qum# La hoja de aliso es bueno para la broza	Ri rxaq limobʼ utz kchuknik chi ri qʼyees	qum is the flowering-leave-like
#qum# El caballo se cayó por mucha carga	Ri keej xtzaqik rum wu xaq et rchim	qum the horse because of the heavy weight.
#qum# El bebé resbaló en la cascara de la fruta	Ri ajkʼal kjilpji k pri riij loʼn	qum, the baby is drawn into the fruit basket.
#qum# El señor le dejo toda la tierra a su nieto	Ri tatyoox xyaʼken njeel ri uleew chu ri rmon	qum, and the Lord will give the whole land to his grandchild
#qum# Los zapatos de la señorita les quedo flojo Jaula	Wu xjabʼ koʼl xiʼ kanajken pirqan wu aliit	qum's shoe are loose.
#qum# La comadreja se terminó de comer las gallinas	Wu saqtbʼiin mixeʼrkʼis ri akʼ c htijik	qumle the chickens by the hare.
#qum# Cuatro mesas grandes servirán para comer	Kji bʼ nmaq meex xkiʼchuknik rech weʼbʼal	qum, and four large tables will be used for food
#qum# Todos los lapiceros ya están divididos a los niños	Njeel ri tzʼibʼbʼal jachmaj chik chke ri ajkʼalobʼ	qumile all the pencils are already distributed to the children.
#qum# La mata de aguacate se está secando por el	Ri rqan ooj tjin rchiqik rum wu tzrabʼ	qum-shap-shap-shap-shap-shap-shap-shap-shap-shap-shap-shap-shap-shap-shap-shap-shap-shap-shap-shap-shap-shap-shap-shap-shap-shap-shap-shap-shap-shap-shap-shap-shap-shap-shap-shap-shap-shap-shap-shap-shap-shap-shap-shap-shap-shap-shap-shap-shap-shap-shap-shap-shap-shap-shap-shap-shap-shap-shap-shap-shap-shap-shap-shap-shap-shap-shap
#qum# Cuando bajamos a la orilla del río es muy	Ataq kojqajbʼik chchiʼ ri yaʼ xibʼal kliswik	qum the river, it is very
#qum# El hombre cuando	Ri achii ataq kirbʼsuj rbʼanik jun chaak, xtbsuj ri qʼiij chu rkʼisbʼaal	qumqumqumqumqumqumqumqumqumqumqumqumqumqumqumqumqumqumqumqumqumqumqumqumqumqumqumqumqumqumqumqumqumqumqumqumqumqumqumqumqumqumqumqumqumqumqumqumqumqumqumqumqumqumqumqumqumqumqumqumqumqumqumqumqumqumqumqumqumqumqumqumqumqumqumqumqumqumqumqumqumqumqumqumqumqumqumqumqumqumqumqumqumqumqumqumqumqumqumqumqumqumqumqumqumqumqumqumqumqumqumqumqumqumqumqumqumqumqumqumqumqumqumqumqumqumqumqumqumqumqumqumqumqumqumqumqumqumqumqumqumqumqumqumqumqumqumqumqumqumqumqumqumqumqumqumqumqumqumqumqumqumqumqumqumqumqumqumqumqumqumqumqumqumqumqumqumqumqumqumqumqumqumqumqumqumqumqumqumqumqumqumqumqumqumqumqumqumqum
#qum# La cara de la vaca se ve alargada	Tzʼajtzʼik rkaʼyxik ri rwoch ri waakx	qumqumqumqumqumqumqumqumqumqumqumqumqumqumqumqumqumqumqumqumqumqumqumqumqumqumqumqumqumqumqumqumqumqumqumqumqumqumqumqumqumqumqumqumqumqumqumqumqumqumqumqumqumqumqumqumqumqumqumqumqumqumqumqumqumqumqumqumqumqumqumqumqumqumqumqumqumqumqumqumqumqumqumqumqumqumqumqumqumqumqumqumqumqumqumqumqumqumqumqumqumqumqumqumqumqumqumqumqumqumqumqumqumqumqumqumqumqumqumqumqumqumqumqumqumqumqumqumqumqumqumqumqumqumqumqumqumqumqumqumqumqumqumqumqumqumqumqumqumqumqumqumqumqumqumqumqumqumqumqumqumqumqumqumqumqumqumqumqumqumqumqumqumqumqumqumqumqumqumqumqumqumqumqumqumqumqumqumqumqumqumqumqumqumqumqumqumqumqum
#qum# La araña come las moscas que están en la pared	Wu am kertij ri us ri ikʼoʼk chu xaan	qum the birds that are on the wall the sphinx eats the flies that are on the wall
#qum# Kkanjik	Ataq kpetik nim jabʼ xibʼal ri senyabʼ	qumamaamaamaamaamaamaamaamaamaamaamaamaamaamaamaamaamaamaamaamaamaamaamaamaamaamaamaamaamaamaamaamaamaamaamaamaamaamaamaamaamaamaamaamaamaamaamaamaamaamaamaamaamaamaamaamaamaamaamaamaamaamaamaamaamaamaamaamaamaamaamaamaamaamaamaamaamaamaamaamaamaamaamaamaamaamaamaamaamaamaamaamaamaamaamaamaamaamaamaamaamaamaamaamaamaamaamaamaamaamaamaamaamaamaamaamaamaamaamaamaamaamaamaamaamaamaamaamaamaamaamaamaamaamaamaamaamaamaamaamaamaamaamaamaamaamaamaamaamaamaamaamaamaamaamaamaamaamaamaamaamaamaamaamaamaamaamaamaamaamaamaamaamaamaamaamaamaamaamaamaamaamaamaamaamaamaamaamaamaamaamaamaamaamaamaamaamaama
#qum# mi papá tiene muchos parientes por eso no se mantiene en la casa	Ri wjow kʼiy richlaal sichaʼ qal kkʼuqbʼik chjaay	qum, and so he does not remain at home.
#qum# Vejez	Ataq kpetik jabʼ njeel ri qʼoos krexbʼik	qumqumqumqumqumqumqumqumqumqumqumqumqumqumqumqumqumqumqumqumqumqumqumqumqumqumqumqumqumqumqumqumqumqumqumqumqumqumqumqumqumqumqumqumqumqumqumqumqumqumqumqumqumqumqumqumqumqumqumqumqumqumqumqumqumqumqumqumqumqumqumqumqumqumqumqumqumqumqumqumqumqumqumqumqumqumqumqumqumqumqumqumqumqumqumqumqumqumqumqumqumqumqumqumqumqumqumqumqumqumqumqumqumqumqumqumqumqumqumqumqumqumqumqumqumqumqumqumqumqumqumqumqumqumqumqumqumqumqumqumqumqumqumqumqumqumqumqumqumqumqumqumqumqumqumqumqumqumqumqumqumqumqumqumqumqumqumqumqumqumqumqumqumqumqumqumqumqumqumqumqumqumqumqumqumqumqumqumqumqumqumqumqumqumqumqumqumqumqum
#qum# Todo el maíz se apolillo	Njeel ri ixiim xpokʼrik	qum qotqqqqqqqqqqqqqqqqqqqqqqqqqqqqqqqqqqqqqqqqqqqqqqqqqqqqqqqqqqqqqqqqqqqqqqqqqqqqqqqqqqqqqqqqqqqqqqqqqqqqqqqqqqqqqqqqqqqqqqqqqqqqqqqqqqqqqqqqqqqqqqqqqqqqqqqqqqqqqqqqqqqqqqqqqqqqqqqqqqqqqqqqqqqqqqqqqqqq
#qum# por el daño que el hombre está	Ri uleew tjin rmeqʼik rum wu kʼex ri tjin kirbʼan ri achii chre	qumation by the harm caused to the human being
#qum# La masa salió quebrada	Ri qʼoor chqaam xelul	qumqumqumqumqumqumqumqumqumqumqumqumqumqumqumqumqumqumqumqumqumqumqumqumqumqumqumqumqumqumqumqumqumqumqumqumqumqumqumqumqumqumqumqumqumqumqumqumqumqumqumqumqumqumqumqumqumqumqumqumqumqumqumqumqumqumqumqumqumqumqumqumqumqumqumqumqumqumqumqumqumqumqumqumqumqumqumqumqumqumqumqumqumqumqumqumqumqumqumqumqumqumqumqumqumqumqumqumqumqumqumqumqumqumqumqumqumqumqumqumqumqumqumqumqumqumqumqumqumqumqumqumqumqumqumqumqumqumqumqumqumqumqumqumqumqumqumqumqumqumqumqumqumqumqumqumqumqumqumqumqumqumqumqumqumqumqumqumqumqumqumqumqumqumqumqumqumqumqumqumqumqumqumqumqumqumqumqumqumqumqumqumqumqumqumqumqumqumqum
#qum# La botella se utiliza para guardar miel	Ri limeet kchuknik chi r kʼolik ri ryaʼl chʼoxiʼ	qum, and the other is the salt of the earth.
#qum# Vamos todos para que nos atieden nuestra	Joʼ qonjeel rech xkojtaʼtjik che ri qajbʼeej	qum, and we all want them to take care of us.
#qum# El río creció por eso se llevó toda la	Ri nimaya ʼ xkʼiyik sichaʼ xuʼrmaʼ njeel ri tikaʼ	qum, so it took up the whole
#qum# El árbol es grandicimo por eso le pego el rayo	Jomom ri cheʼ sichaʼ xkʼeq rquljaay	qum is large, so I will beat him.
#qum# El frijol que se compra en la plaza lo	Ri knaqʼ ri kloqʼik pkʼeybʼal esmaj jun pajbʼal	qum's the bean that you buy in the square,
#qum# Cuando cómo frijol me da ardor de pecho	Ataq kintij knaqʼ kiryaʼ qʼaʼteew chwa	"qumilil.com ""If it is like a bacon that pops into my belly"
#qum# Todas las frutas están rodajeada con cuchillo	Njeel wu loʼn jexmaj rukʼ qʼatbʼal	qumile crop is all filmed with a knife
#qum# Ayer mi mamá compró hilo de varios colores	Iwir ri nchuch xloqʼ bʼatzʼ pkʼeybʼal jaljoj kkaʼybʼaal	qumle, and my mother bought multicolored thread yesterday.
#qum# El ladrón fue arrastrado por las	Ri elqʼoom xqitxik kum ri wnaq xaq rum wu xrelqʼaaj jun keej	qum, and the thief was made by the
#qum# Las matas de maguey se están secando por la plaga	Ri rqan kiiy tjin rchiqik rum wu xoʼkik chkop txeʼ	qumla the forests of Maguey by the plage.
#qum# Cuando se come un chompipe quiere mucho	Ataq ktijik jun chooj nim rkunaal kraaj	qum, and will have plenty and plenty of champagne when you sip
#qum# Todo el techo de ,la casa gotea	Njeel ri rwiʼ jaay ktzʼujik	qum the entire roof of the house.
#qum# Quemar bien	El enfermo se empeoro porque salio bajo la lluvia	qumayoqayoqayoqayoqayoqayoqayoqayoqayoqayoqayoqayoqayoqayoqayoqayoqayoqayoqayoqayoqayoqayoqayoqayoqayoqayoqayoqayoqayoqayoqayoqayoqayoqayoqayoqayoqayoqayoqayoqayoqayoqayoqayoqayoqayoqayoqayoqayoqayoqayoqayoqayoqayoqayoqayoqayoqayoqayoqayoqayoqayoqayoqayoqayoqayoqayoqayoqayoqayoqayoqayoqayoqayoqayoqayoqayoqayoqayoqayoqayoqayoqayoqayoqayoqayoqayoqayoqayoqayoqayoqayoqayoqayoqayoqayoqayoqayoqayoqayoq
#qum# La reun ion se realiza cada semana	Ri molbʼeem kbʼanik chwuqubʼ qʼiij	qum on the weekly basis
#qum# El árbol se le seco las hojas	Ri cheʼ xchiqik ri rxaq	qum dried the leaves
#qum# Con el doblador se hacen muñecas decoradas	Rukʼ wu joʼq keʼ bʼanik qʼus laj alaʼs	qum to the surface of the earth.
#qum# el coyote se comió l as once ovejas	Julajuuj chiij xeʼr tij ri sjiʼl	qum the eleven sheep by the coyote.
#qum# El hombre se go lpeó la	Ri achii xkʼoxbʼsaj ri rjlom ataq xtzaqik rukʼ ri jochlan chʼiichʼ	qumalo laymathon (laymathon) The man has become the
#qum# El frujol blanco es delicioso comer en	Ri knaqʼ saqtbʼin chetzʼiʼnik rtijik pjkʼom iik	qum, and the white fruit is delicious to eat in
#qum# L avado	El cerdo ensució el maíz	qum, and so forth.
#qum# La mujer hace lasos con la	Ri ixoq kiʼrbʼan ri klobʼ rukʼ ri saqkiiy ri kirbʼan rukʼ ri choʼl	qum qqqqqqqqqqqqqqqqqqqqqqqqqqqqqqqqqqqqqqqqqqqqqqqqqqqqqqqqqqqqqqqqqqqqqqqqqqqqqqqqqqqqqqqqqqqqqqqqqqqqqqqqqqqqqqqqqqqqqqqqqqqqqqqqqqqqqqqqqqqqqqqqqqqqqqqqqqqqqqqqqqqqqqqqqqqqqqqqqqqqqqqqqqqqqqqqqqqqqq
#qum# El ayote es bien rico pa ra comer	Chetzʼiʼnik rtijik ri qʼooqʼ	qum) is very rich in food
#qum# Cerca murió el marido de la mujer	Nqaaj waʼchiʼ xchupik ri rchjiil ri ixoq	qum, and the man of the woman died in the immediate vicinity.
#qum# Todo el tamal estaba comido por las ratas	Njeel ri subʼ tijmaj rum chʼoo y ataq xojsaqrik	qum, and all the tamal was eaten by the rats.
#qum# Arena	Ataq kiʼjikxik ri cheʼ ri uleew sbʼajbʼoj kkanjik	qumqumqumqumqumqumqumqumqumqumqumqumqumqumqumqumqumqumqumqumqumqumqumqumqumqumqumqumqumqumqumqumqumqumqumqumqumqumqumqumqumqumqumqumqumqumqumqumqumqumqumqumqumqumqumqumqumqumqumqumqumqumqumqumqumqumqumqumqumqumqumqumqumqumqumqumqumqumqumqumqumqumqumqumqumqumqumqumqumqumqumqumqumqumqumqumqumqumqumqumqumqumqumqumqumqumqumqumqumqumqumqumqumqumqumqumqumqumqumqumqumqumqumqumqumqumqumqumqumqumqumqumqumqumqumqumqumqumqumqumqumqumqumqumqumqumqumqumqumqumqumqumqumqumqumqumqumqumqumqumqumqumqumqumqumqumqumqumqumqumqumqumqumqumqumqumqumqumqumqumqumqumqumqumqumqumqumqumqumqumqumqumqumqumqumqumqumqumqum
#qum# El formón lo utiliza el carpintero	Ri tzʼqubʼ kchuknik chu ri jsol cheʼ	qum is used by the carpenter.
#qum# El conejo cuando hay buena luna sale a comer el frijol	Ri imul ataq kʼolik rqan iikʼ kelul chirtijik wu knaqʼ	qum the hare goes out to eat the tree on a beautiful moon.
#qum# La mujer cuando mató a la gallina	Ri ixoq ataq xwiʼtaaj ri akʼ kʼa xlechʼpij ri rtzʼumil	qum the woman who killed the hen
#qum# El documeto del terreno está ahumado	Ri rjujil uleew xsibʼrik wu riij	qum) The document from the plot is smoky.
#qum# La flor de milpa lo come las chorchas	Ri tzʼtuj ktij tochʼaʼ chu kwoy	qumle is eaten by the crows
#qum# Es necesario cuidar la naturaleza	Riliil riij xtloqʼxik ri uleew	qumilil.com - Nature must be maintained by
#qum# La mayoría de los niños consumen mucha galguería	Ri knimalil ri ajkʼalobʼ ktij tzʼiʼlil	qumilika is a very common cause of death. most children consume a great deal of gallery
#qum# Cuando entra el verano las vacas se ponen flacos	Ataq kokik saqʼiij yaax keʼlik ri waakx	qum, when the summer comes, the cows will be slain
#qum# El niño se majó el dedo	Ri ajkʼaal xwochʼ wu rwiʼ rqʼabʼ	qum the boy with his finger.
#qum# Boca arriba	Ri nchuch xloqʼ ri paa kʼ pkʼeybʼal	qumla the mouth.
#qum# El niño no guantó porque se le regó agua	Ri ajkʼaal qal xchʼij kumu kʼten yaʼ xtixuul chriij	qum, the boy was wearing no gloves because he had been given water.
#qum# La mariposa vuela entre las flores	Wu puʼt kxikʼnik chu taq ri kotzʼaj	qum-shaped flowers by the butterfly flying between the
#qum# Todos los enfermos sanaron	Njeel ri ya abʼ mixuʼtzrik	qumla. all the sick are well
#qum# La milpa se secó porque le cayó hielo	Ri chnooj xchiqik kumu xqaaj teew chriij	qumed by the ice on the milpe.
#qum# El frijol amarillo da cuando se siembra	Ri xpley kiryaʼ ataq jnum kawxik rukʼ ri chnooj	qumile the yellow bean when planted
#qum# El agua tiene pureza	Ri yaʼ kʼolik rsaqiil	qumlo, and the water is pure
#qum# El techo de la casa de mi papá se ve de forma triangulo	Jutzʼjik rkaʼxik ri rwiʼ rchoch wjow	qum's house is a triangle.
#qum# Cuando el buhuo llega a	Ataq koʼqʼoʼk ri toltol chjaay labʼnel kʼolik chinaq xtkmik	qumqqq qqqqqqqqqqqqqqqqqqqqqqqqqqqqqqqqqqqqqqqqqqqqqqqqqqqqqqqqqqqqqqqqqqqqqqqqqqqqqqqqqqqqqqqqqqqqqqqqqqqqqqqqqqqqqqqqqqqqqqqqqqqqqqqqqqqqqqqqqqqqqqqqqqqqqqqqqqqqqqqqqqqqqqqqqqqqqqqqqqqqqqqqqqqqqqqqqqq
#qum# La reunión de los estudiantes se hizo anteayer	Ri molbʼeem kech ri aj tijnel xbʼanik kabʼjiir	qumle, which took place on the same day.
#qum# Mi mamá tiene sirvienta	Ri nchuch kʼolik rmkoom	qum, and his mother-in-law and mother-in-law.
#qum# Los niños empezaron a llorar cuando perdieron	Ri ajkʼalobʼ xeʼoqʼik rum qal xkchʼak ri etzʼnim	qumile the children when they lost.
#qum# Nuestro idioma es el Sipakapense	Ri qyolbʼaal areʼ ri Sipakapense	qum qʼoʼl qʼoʼl qʼoʼlqʼik
#qum# Por un poco no alcanzo el fuego la otra casa	Xaq qiʼn chik qal xmaj qʼaaqʼ ri jun jaay chik	qum's to the other house for a little while
#qum# El mal de ojo les afecta a los	Ri rbʼaqʼ rwoch wnaq kirbʼan kʼex chke ri ajkʼ a lobʼ	qumers of the eye.
#qum# No es bueno comer el sobrante al otro día	Qal utz xtqtij ri chʼqaap	qumile, and it is not good for the day to come.
#qum# A todas las	Chke njeel ri wnaq xbʼiʼxik ke qal xeʼlbʼik xkoybʼeej ke xkʼisik ri molbʼeem	qumla) (a) all the
#qum# Para la fiesta del pueblo todos damos la contribución Ri achii xkanajken	Rech ri nima qʼiij rech tinmit qonjeel qyaʼ ri kchuuj	qumle the feast of the village we all lay a
#qum# Todo el trabajo que se realizó estaba bien pensado por eso salió bien	Njeel ri chaak ri xbʼanik bʼusmaj riij sichaʼ utz xeʼloq	qum, so that it is well-executed.
#qum# Por allá está la casa de mi hermana	Tukkilaʼ kʼolik r i rchoch ri wnobʼ	qum, which is my sister-in-law's house.
#qum# Las flores que tiene sembrado mi mamá son de color rojo	Njeel ri kotzʼaj ri rawmaj ri nchucch keq rkaʼybʼaal	qumile, and the flowers that my mother planted are purple.
#qum# Los trabajos de los antiguos ya no se encuentran	Ri kchak ri ojor wnaq qaqchee chik kiʼ riqt jik	qumqqqqqqqqqqqqqqqqqqqqqqqqqqqqqqqqqqqqqqqqqqqqqqqqqqqqqqqqqqqqqqqqqqqqqqqqqqqqqqqqqqqqqqqqqqqqqqqqqqqqqqqqqqqqqqqqqqqqqqqqqqqqqqqqqqqqqqqqqqqqqqqqqqqqqqqqqqqqqqqqqqqqqqqqqqqqqqqqqqqqqqqqqqqqqqqqqqqqqq
#qum# El granizo golpeo la milpa	Ri saqbʼuch xkʼoxbʼsaaj ri chno oj	qum's bill the milpe
#qum# Al niño le da estornudo	wu ajkʼaal kiryaʼ achyam chre	qum the boy
#qum# Codo	Pongale una cuña a la mesa	qumqumqumqumqumqumqumqumqumqumqumqumqumqumqumqumqumqumqumqumqumqumqumqumqumqumqumqumqumqumqumqumqumqumqumqumqumqumqumqumqumqumqumqumqumqumqumqumqumqumqumqumqumqumqumqumqumqumqumqumqumqumqumqumqumqumqumqumqumqumqumqumqumqumqumqumqumqumqumqumqumqumqumqumqumqumqumqumqumqumqumqumqumqumqumqumqumqumqumqumqumqumqumqumqumqumqumqumqumqumqumqumqumqumqumqumqumqumqumqumqumqumqumqumqumqumqumqumqumqumqumqumqumqumqumqumqumqumqumqumqumqumqumqumqumqumqumqumqumqumqumqumqumqumqumqumqumqumqumqumqumqumqumqumqumqumqumqumqumqumqumqumqumqumqumqumqumqumqumqumqumqumqumqumqumqumqumqumqumqumqumqumqumqumqumqumqumqumqum
#qum# Salimos rápido por eso regresamos juntos	Cha niim xojelbʼ ik sichaʼ xojtz aljuul jnum	qumile, and we will come back together.
#qum# El lápiz del estudiante se quebró	Ri rtzʼibʼbʼaal ri ajtijnel xqʼeptjik	qumle of the student's head is broken.
#qum# El cabello de la señorita está trensado con su	Ri rwiʼ ri aliit pochʼmaj rukʼ ri rxqʼap	qum of the woman's hair are with her
#qum# Ante el juez no se presentó el acusador	Chu ri qʼtal iil qal ri tzujnel xopnik	qumants have not been brought to the attention of the judge.
#qum# C ama wu chʼaat bʼantlik rukʼ	Estaba mojado la camisa del hombre por eso le dio fiebre	qum xbʼal xbʼeel xbʼoʼl ri xbʼooj
#qum# El hom bre tiene bellos en el pecho	ri achii kʼolik rsmaal chu rkʼuʼx	qum qʼoʼl qʼoʼqʼoʼl qʼoʼqʼoʼl qʼoʼqʼoqʼoʼl qʼoqʼoqʼoqʼqʼoqqqʼoqʼqʼoqʼl qʼoʼqʼoqʼoqqqʼoqʼoqʼl qʼoqʼoqʼl qʼoʼoqʼoqʼoqqqqʼoqqʼoqqʼoqqʼqʼoq
#qum# Pizarron	La tabla es ancha	qum's a pitzard you are a pitzard
#qum# El bebé gatea en el patio de la casa	Ri neʼ kchaknik pirqan jaay	qum qqqqqqqqqqqqqqqqqqqqqqqqqqqqqqqqqqqqqqqqqqqqqqqqqqqqqqqqqqqqqqqqqqqqqqqqqqqqqqqqqqqqqqqqqqqqqqqqqqqqqqqqqqqqqqqqqqqqqqqqqqqqqqqqqqqqqqqqqqqqqqqqqqqqqqqqqqqqqqqqqqqqqqqqqqqqqqqqqqqqqqqqqqqqqqqqqqqqqq
#qum# Hay personas que ya no se recuerda de	Kʼolik wnaq qal chik knaʼtaj ri kbʼanbʼaal chke	qum, there are people who do not have any
#qum# La señora ronca mucho cuando duerme	Wu ixoq kjororik wu rtzaʼm ataq kwrik	qumui, the woman sneeres greatly when she is asleep.
#qum# La hoja de papel esta medio pegado	Ri rxaq juuj xaq qiʼn nakʼlook	qum, the leaf is half-tailed.
#qum# La gente cando existe entre ellos un problema se desprecian	Ri wnaq ataq kʼolik jun chʼoʼj chkxoʼl ketzlaj kiibʼ	qum, and when there is any doubt of any kind between them, the people despise one another.
#qum# El encendedor sirve para juntar el	Ri tʼiqbʼal kchuknik chu rnukʼik ri qʼaaqʼ	qum, and the fire is used to make the
#qum# Cuando se junta	Ataq kmo lik ri knaqʼ kʼolik rkʼolbʼaal waʼchiʼ kyoʼqqaj wiʼ	qum'd when it comes together
#qum# Donde yo vivo es tierra caliente	Ri waʼchiʼ kʼo ri wchoch mqʼen jyubʼ	qum'a's hot land is where I live
#qum# C uando amanecemos el gallo canta	Ataq kojsaqrik ri tzeek koqʼik	qum, when it is early, the rooster sings
#qum# Todas las bancas son redondas	Njeel ri teem isetsik	qum winding the banks are round
#qum# Cuando se tapisca la	Ataq kjachʼik ri jal xaq xeew ri rqan chnooj kkanjik	qumate the size of the
#qum# La masa salió fino en el molino	wu qʼoor kookʼ xelul pwu keʼbʼal	qumla, and the mass has been well-turned-mill.
#qum# Ri ixoq	Tráigalo	qum xbʼal xbʼaʼ
#qum# La escuela cumplió el decimo sexto año de	Rwaqlaaj rjnobʼ ri tijbʼal xtzʼaqtik	qum in the 16th year of the school's
#qum# La fruta está medio ácido	Ri loʼn chʼomchʼoj rtijik	qum is half-sour
#qum# Los zapatos de mi abuelo es de color negro	Ri rxjabʼ ntatanool qʼeq kkaʼybʼaal	qum) is black.
#qum# Todas las hojas de papel se perforó	Njeel ri rxaq juuj xeʼ worik	qumate, all the sheet papers were pierced through the
#qum# La vaca es de mejilla gorda Extendido	Ri waakx lewlik wu rwoch	qum-bastel-bastel is the cow that is fat-bastel
#qum# Para espantar a los zanates sirve la onda de pita	Chu kxibʼxik ri chʼok kchuknik ri ixkeeqʼ	qum, the whale of the sea will be able to roam the earth, but the spirit of Satan will be able to help him if he chooses
#qum# Todos los niños se dispersaron por el miedo	Njeel ri ajkʼalobʼ xiʼ tuknik rum xibʼal kiibʼ	qum all the children out of fear.
#qum# El hombre ya es viejo por eso no aguanta caminar	Ri achii riʼj chik sichaʼ qal kirchʼij kbʼinik	qum is old, and therefore cannot walk.
#qum# Es necesario mostrar lo que se quiere	Riliil riij xtkʼutik ri kajwxik rbʼanik kukʼ ri wnaq	qumile, and you'll have to show what you want.
#qum# La	Ri yuʼtz kʼebʼ muul xchuknik sichaʼ kamulbʼal rbʼiʼxik pqyolbʼaal	qumsiqsiqqsiqqsiqsiqsiqsiqsiqsiqsiqsiqsiqqsiqsiqsiqsiqsiqsiqsiqsiqsiqsiqsiqsiqsiqsiqsiqsiqsiqsiqsiqsiqsiqsiqsiqsiqsiqsiqsiqsiqsiqsiqsiqsiqsiqsiqsiqsiqsiqsiqsiqsiqsiqsiqsiqsiqsiqsiqsiqsiqsiqsiqsiqsiqsiqsiqsiqsiqsiqsiqsiqsiqsiqsiqsiqsiqsiqsiqsiqsiqsiqsiqsiqsiqsiqsiqsiqsiqsiq
#qum# La tortuguilla terminó de comer el frijol	Wu leem xkʼis ri knaqʼ	qum, the turtle has eaten the tree.
#qum# L a haba se muele para pinol	Wu jaws kkeʼxik chu kʼej	qum qib qibla qibla qibla qibla qibla qibla qibla qibla qibla qibla qibla qibla qibla qibla qibla qibla qibla qibla qibla qibla qibla qibla qibla qibla qibla qibla qibla qibla qibla qibla qibla qibla qibla qibla qibla qibla qibla qibla qibla qibla qibla qibla qibla qibla qibla qibla qibla qibla qibla qibla qibla qibla qiblaiblaibla qiblaiblaibla qibla qiblaibla
#qum# El trabajo está duro por eso no avanzaron los trabajadores	Wu chaak kow sichaʼ qal nim xkbʼan ri ajchaak	qum, and the workers did not progress.
#qum# La olla grande es de boca grande	Wu nima xbʼoʼj leʼlik wu rchiʼ	qum the big pot has a big mouth.
#qum# La abuela le duele su hueso	Ri nooy kiʼ qʼoxwik ri rbʼaqil	qum is a bone-chord wound to him by the grandmother.
#qum# Mi perro se murió despacio ór la vejez	Tkaal xkmik ri ntzʼiʼ rum riʼjaal	qum is slow to die, or to age.
#qum# En la reunión llegaron solo dos mujeres	Pri molbʼeem xaq kʼeebʼ ixoq xoʼpnik	qum; only two women came to the meeting.
#qum# Si hablamos con la verdad	Saqsi xkojyolwik chqatziij rtqriq kʼchiʼ ri utziil	qum't't's when we tell the truth
#qum# En el terreno hay montones de piedras	Pri uleew kʼolik kʼiy amluʼx abʼaj	qum on the ground.
#qum# Para que no nos critiquen es bueno pagar la deuda	Rech qal xkojyolik, utz xttojik ri kʼaas	qum is good for the plaintiff to be unquestionable .
#qum# Las aguas estancadas no es bueno	Ri tikʼlik yaʼ qal utz kumu kiʼ poqʼnik ri raal us	qumayo is not good standing water
#qum# El perro es travieso	Ri tzʼiʼ xwos	qum is evil.
#qum# Existen personas que no creen en las imágenes	Kʼolik ri wnaq qal knmaj ri tyoox	qum, and there are those who do not believe in images.
#qum# Que fecha nació mi hermano	Che rajlbʼaal rkʼosbʼik r i wtziik	qum, when was my brother born?
#qum# M i mamá está enfermo de la tos	Ri nchuch yaabʼ rukʼ rqul	qum, and his mother is sick with coughing.
#qum# la comadrona vive en el traingulo	Ri ajkuun tlaʼ kʼolik rchoch waʼchiʼ rbʼiʼ oxchʼuʼk	qum in the life of the sister-in-law.
#qum# La gall inaza es bueno para abonar la siembra	Ri rchaq akʼ utz xtqajik chxeʼ ri tikaʼ	qumilika is good for fertilization
#qum# Cuando hay charcos de agua	Ataq kʼolik yaʼ tikʼlik xibʼal serat kiʼpoqʼnik	qum's water's water's water's water's water's water's water's water's water's water's water's water's water's water's water's water's water's water's water's water's water's water's water's water's water's water's water's water's water's water's water' water's water' water's water's water' water's water's water's water's water's water's water's water's water's water's water's water' water's water's water' water's water's water's water's water's water' water' water' water' water's water's water' water's water's water' water's water' water' water'
#qum# El ladrón entró arriba por eso no se dio cuenta el perro	ajsik xokul ri elqʼoom sicha ʼ qal xnaʼ ri tzʼiʼ	qum'd the thief came up, so the dog did not notice.
#qum# Cuando nacio el niño lo	Ataq xkʼosbʼik ri ajkʼaal rbʼaqʼtmaj riibʼ ri rkʼamaʼl rmuux pirqul	qum when the child is born
#qum# El caballo tiene los ojos grandes	Ri keej bʼilbʼik wu rbʼaq rwoch	qum the horse has large eyes.
#qum# Barrendero	El cuarto lo han barrido	qumqumqumqumqumqumqumqumqumqumqumqumqumqumqumqumqumqumqumqumqumqumqumqumqumqumqumqumqumqumqumqumqumqumqumqumqumqumqumqumqumqumqumqumqumqumqumqumqumqumqumqumqumqumqumqumqumqumqumqumqumqumqumqumqumqumqumqumqumqumqumqumqumqumqumqumqumqumqumqumqumqumqumqumqumqumqumqumqumqumqumqumqumqumqumqumqumqumqumqumqumqumqumqumqumqumqumqumqumqumqumqumqumqumqumqumqumqumqumqumqumqumqumqumqumqumqumqumqumqumqumqumqumqumqumqumqumqumqumqumqumqumqumqumqumqumqumqumqumqumqumqumqumqumqumqumqumqumqumqumqumqumqumqumqumqumqumqumqumqumqumqumqumqumqumqumqumqumqumqumqumqumqumqumqumqumqumqumqumqumqumqumqumqumqumqumqumqumqum
#qum# Mi mamá puede hacer petate	Ri nchuch utz keʼrbʼan ri xkulbʼal	qum may may be made with rolled peach of piezet
#qum# La en voltura del papel está hecho de algodón	Ri pisbʼal ri juuj bʼantlik rukʼ miit	qumqumqumqumqumqumqumqumqumqumqumqumqumqumqumqumqumqumqumqumqumqumqumqumqumqumqumqumqumqumqumqumqumqumqumqumqumqumqumqumqumqumqumqumqumqumqumqumqumqumqumqumqumqumqumqumqumqumqumqumqumqumqumqumqumqumqumqumqumqumqumqumqumqumqumqumqumqumqumqumqumqumqumqumqumqumqumqumqumqumqumqumqumqumqumqumqumqumqumqumqumqumqumqumqumqumqumqumqumqumqumqumqumqumqumqumqumqumqumqumqumqumqumqumqumqumqumqumqumqumqumqumqumqumqumqumqumqumqumqumqumqumqumqumqumqumqumqumqumqumqumqumqumqumqumqumqumqumqumqumqumqumqumqumqumqumqumqumqumqumqumqumqumqumqumqumqumqumqumqumqumqumqumqumqumqumqumqumqumqumqumqumqumqumqumqumqumqumqum
#qum# Todos los negocios están cerrados	Njeel ri kʼyeej itzʼaplik	qum's all the shops are closed.
#qum# Dirrecion	Xsqarsxik ri riil ri achii se aclaró el delito del hombre	qumqumqumqumqumqumqumqumqumqumqumqumqumqumqumqumqumqumqumqumqumqumqumqumqumqumqumqumqumqumqumqumqumqumqumqumqumqumqumqumqumqumqumqumqumqumqumqumqumqumqumqumqumqumqumqumqumqumqumqumqumqumqumqumqumqumqumqumqumqumqumqumqumqumqumqumqumqumqumqumqumqumqumqumqumqumqumqumqumqumqumqumqumqumqumqumqumqumqumqumqumqumqumqumqumqumqumqumqumqumqumqumqumqumqumqumqumqumqumqumqumqumqumqumqumqumqumqumqumqumqumqumqumqumqumqumqumqumqumqumqumqumqumqumqumqumqumqumqumqumqumqumqumqumqumqumqumqumqumqumqumqumqumqumqumqumqumqumqumqumqumqumqumqumqumqumqumqumqumqumqumqumqumqumqumqumqumqumqumqumqumqumqumqumqumqumqumqumqum
#qum# En el camino se regó arena	Chpom ri bʼeey xtukxik poqlaaj	qum the road, sand was washed
#qum# La ropa está mojada	Ri sʼaq tʼaq	qum is wet.
#qum# Cuando el perro olió las huellas del	Ataq xsiq ri tzʼiʼ ri qan chkop xtrambʼeej rech xwiʼtaaj	qumilid to the ground, and when the dog's footprints of
#qum# La señorita se le cayó la muela	Ri aliit xtzaqeel wu rkaʼ	qum) The woman has lost the tooth.
#qum# El perro lo hirió al hombre en la fosa poplítea	Ri tzʼiʼ xsok ri achii pirsmoqʼ	qum, the dog injured the man in the slaughterhouse.
#qum# El consumo del cigarro daña el cerebro	Ri siikʼ kirbʼan kʼex chu ri tzantzqʼor	qum on the brain is a harmful effect on the brain
#qum# Frijol	Ataq kpetik jabʼ wu kʼotzʼaj qʼus kkaʼyxik	qum qomqom qʼoʼn
#qum# Cuando está bien hecho el trabajo no es necesario repasarlo	Ataq utz bʼanmaj ri chaak qal chik ktzuntzxik	qumle, and if the work is done well, one does not need to re-
#qum# El hombre que mató a la mujer es el culpable	Ri ajmaak areʼ ri achi i ri xwiʼt aaj ri ixoq	qum, and the man who killed the woman is guilty.
#qum# El pajon blanco sirve para elaborar canastas	Ri saqkʼim kchuknik chu kbʼanik xuʼk	qumlaq qʼijbʼel qʼijbʼel qʼijbʼel qʼijbʼel qʼijbʼel qʼijbʼel qʼijbʼel qʼijbʼel qʼijbʼel qʼijbʼel qʼijbʼel qʼijbʼel qʼijbʼel qʼijbʼel qʼijbʼel qʼijbʼel qʼijbʼel qojbʼo qʼoojbʼel qojbʼo qojbʼoqʼoojbʼoojbʼoq qojbʼoojbʼoojbʼoojbʼoojbʼooj
#qum# La casa es muy reducido por eso no	Latzʼ wu rpom jaay sichaʼ qal xiʼ kʼisook njeel ri wnaq	qum is very small, so it is not.
#qum# Cunado cae las primeras lluvias salen	Ataq kqajik ri nabʼey rqan jabʼ keʼlul ri xkawalek	qumando con la muerte de la muerte
#qum# El aguardiente causa daños a nuestro hígado	Ri xbʼaj kirbʼan kʼex chu ri qsosobʼ	qumlo, the water causes damage to the liver
#qum# Debajo de las piedras están las culebras	Xeʼ taq ri abʼaj kiʼkʼobʼik ri kmatz	qum of the rocks are the buttons
#qum# La siembra crece con el calor del sol	Ri tikaʼ kkʼiyik rum ri rmeqʼnal ri qʼiij	qum, and the seed is growing in the heat of the sun
#qum# Entre seis meses va parir la vaca	Waqiibʼ iikʼ chi k xtqajik raal wu wakx	qum is the cow in six months
#qum# Esto lo dijo un chismoso	Jun mlol ylooj xb ʼiʼnik re waʼ	"qum"", said one of the jewelers."
#qum# La nuera se le puso a	Ri albʼatz xyoʼqook chu rqirxik ri rwoch ixiim	qumla-mother-in-law has been
#qum# En la cima del cerro fuimos hacer la ceremonia maya	Pirwiʼ ri jyubʼ xeʼqbʼnaʼ ri chʼabʼal maaya	qum of the mountain, we did the Maya ceremony.
#qum# El muchacho se cortó el pie con el machete	R i alaabʼ xtochʼ ri rqan rukʼ ri tochʼbʼal	qumile the foot with the machete.
#qum# Los ladrones de noche robaron la vaca de mi papá	Ri elqʼoom chaqʼabʼ xkelqʼaaj ri rwaakx wjow	qum's cow was stolen by the night owls.
#qum# la señora siempre padece del catarro	Ri nanyoox xaq kyabʼabʼ ik rum wu re tzaʼm	qum (Run) The woman has snow (Run) all the time
#qum# Mi hermano construyó su casa retirado a la mia	Najeʼl xbʼan ri wtziik ri rchoch	qum, and my brother rebuilt his house upon my house.
#qum# La señorita tiene los pechos grandes	Ri aliit nmaq wu riim	qum has large breasts.
#qum# El buche de la gallina se llenó con granos de maíz	Ri rbʼuch akʼ xnojik rukʼ rwoch ixiim	qumarij (or) the chicken-hulled lard was filled with corn
#qum# En mi pueblo hay pocos ladinos	Pri ntinmit qal kʼiy moos ikʼolik	qum in my village there are few ladins.
#qum# El cuero se secó en el sol	Ri tzʼuum xchiqik chu qʼiij	qum is dry in the sun.
#qum# El niño está enfermo por eso no puede reir	Ri ajkʼaal yaabʼ sichaʼ qal ktzeʼnik	qum, the child is sick, and therefore cannot be laughed.
#qum# La mosca es un animal malo porque contamina lo	Wu us qal utz laj chkop kir chʼulchʼaʼ ri che ri qtij	qum, and the fly is a bad animal because it pollutes it.
#qum# Cuando los niños se levantan todos cantan	Ataq kiʼ waʼljik ri ajkʼalobʼ konjeel keʼ bʼixnik	qumile the children, they will all sing
#qum# A los niños es necesario enseñarles a saludar	Chke ri ajkʼalobʼ riliil rij xkeʼtijxik rech xkeʼqʼajlaʼnik	qum-e-e-e-e-e-e-e-e-e-e-e-e-e-e-e-e-e-e-e-e-e-e-e-e-e-e-e-e-e-e-e-e-e-e-e-e-e-e-e-e-e-e-e-e-e-e-e-e-e-e-e-e-e-e-e-e-e-e-e-e-e-e-e-e-e is the need to teach the children how to know how to greet the
#qum# El escritor escribió varios cuentos en el	Ri ajtzʼibʼnel xeʼrtzʼibʼaaj kʼiy q taʼ pqyolbʼaal	qumle, and the author wrote several stories in
#qum# La señora preguntó cuanto vale la gallina	Ri ixoq xtzʼonjok jrubʼ rjil wu akʼ	qum's wife, and asked what the chicken was worth.
#qum# El lazo se estiro porque se mojó	wu klobʼ xyuqpjik ataq xchnaʼnik	qum, because it is wet.
#qum# Sapo	La laga rtija sale cuando hay sol	qumqumqumqumqumqumqumqumqumqumqumqumqumqumqumqumqumqumqumqumqumqumqumqumqumqumqumqumqumqumqumqumqumqumqumqumqumqumqumqumqumqumqumqumqumqumqumqumqumqumqumqumqumqumqumqumqumqumqumqumqumqumqumqumqumqumqumqumqumqumqumqumqumqumqumqumqumqumqumqumqumqumqumqumqumqumqumqumqumqumqumqumqumqumqumqumqumqumqumqumqumqumqumqumqumqumqumqumqumqumqumqumqumqumqumqumqumqumqumqumqumqumqumqumqumqumqumqumqumqumqumqumqumqumqumqumqumqumqumqumqumqumqumqumqumqumqumqumqumqumqumqumqumqumqumqumqumqumqumqumqumqumqumqumqumqumqumqumqumqumqumqumqumqumqumqumqumqumqumqumqumqumqumqumqumqumqumqumqumqumqumqumqumqumqumqumqumqumqum
#qum# El trozo ya está seco	Ri xaʼk chqiʼj chik	qum is already dry.
#qum# Para curar la tos es bueno el jengibre	Ri xenxipr utz chi kunbʼal ri qulaj	qum-qqqqqqqqqqqqqqqqqqqqqqqqqqqqqqqqqqqqqqqqqqqqqqqqqqqqqqqqqqqqqqqqqqqqqqqqqqqqqqqqqqqqqqqqqqqqqqqqqqqqqqqqqqqqqqqqqqqqqqqqqqqqqqqqqqqqqqqqqqqqqqqqqqqqqqqqqqqqqqqqqqqqqqqqqqqqqqqqqqqqqqqqqqqqqqqqqqqqq
#qum# El laso lo hacen torcer con malacates	Ri klobʼ ktumxik rukʼ xweelx	qum qibal qibal qibal qibal qibal qibal qibal qibal qibal qibal qibal qibal qibal qibal qibal qibal qibal qibal qibal qibal qibal qibal qibal qibal qibal qibal qibal qibal qibal qibal qibal qibal qibal qibal qibal qibal qibal qibal qibal qibal qibal qibal qibal qibal qibal qibal qibal qibal qibal qibal qibal qibal
#qum# El agua de la	Ri ryaʼl tzmeʼy utz xtqum jun ixoq rech q al ri raal xtokʼwik	qum of the earth's surface.
#qum# El borracho cuando cayó quedó de boca arriba	Ri qʼabʼreel pakʼlik xkanjik ataq xtzaqik	qum, the drunkard was on his head when he fell.
#qum# El hombre cuando se fue a traer leña no llevó su mecapal	Ri achii ataq xbʼeek chu rkʼamik siʼ qal xkʼambʼik ri rptem	qum, and the man did not carry his Mecapal when he went to fetch wood.
#qum# El año pasado se fundó el caserío	Junbʼer xkʼuqbʼsxik ri rwiʼ rqʼabʼ tinmit	qum of the house of the land.
#qum# Rech ri tinmit	Njeel jnobʼ kbʼanik ri nimaqʼʼij	qum riij riʼ riqʼij riij
#qum# A la mujer le dió vahído	Ri ixoq xpe saqtqoj chriij	qumile the woman.
#qum# El muchacho se cayó y se quebró la mano	Ri alaabʼ xtzaqik xqʼoch wu rqʼabʼ	qum, and the boy fell and broke his arm.
#qum# Mi hermano apuntaló su casa	Ri wtziik xaq xchʼutij ri rchoch	qumile his house.
#qum# al otro lado del rio está la casa de Elena	Chqʼayaʼpon ri yaʼ kʼolik rchoch ri Leʼn	qumile on the other side of the river is the house of Elenas.
#qum# La cola de gallo sirve para adornar	wu ekʼaʼ kchuknik chu wiqbʼal	qumqqqqqqqqqqqqqqqqqqqqqqqqqqqqqqqqqqqqqqqqqqqqqqqqqqqqqqqqqqqqqqqqqqqqqqqqqqqqqqqqqqqqqqqqqqqqqqqqqqqqqqqqqqqqqqqqqqqqqqqqqqqqqqqqqqqqqqqqqqqqqqqqqqqqqqqqqqqqqqqqqqqqqqqqqqqqqqqqqqqqqqqqqqqqqqqqqqqqqq
#qum# Dolor	Iwir xintzaqken ri qʼaxbʼal chaʼnbʼal ayer perdí el teléfono	qumate the pain.
#qum# Mi tío tiene dos hijastras	Ri wkaan kʼolik kʼeebʼ rmyaʼlbʼaal	qum, and has two daughters.
#qum# Palo blanco	Ri saqʼuul xaq tqʼaaj kiryaʼ wiʼ, El plátano solo se da en la costa	qum white tribe
#qum# Ayer en la tarde estuvimos en una reunión	Iwir xqʼeq xojkʼobʼik pjun molbʼeem	qumays in the afternoon.
#qum# El niño se debe agarrar de la mano	Ri ajkʼaal riliil rij kyuqxik chu ri rqʼabʼ	qumilir. the child must hold the hand
#qum# El maestro lo mando a serntar al abuelo en la silla	Ri ajtiij xkʼuqbʼaʼ ri tatanool chu teem	qum, and the Master sends him to serve the grandfather in the chair.
#qum# Todos tomamos atol	Qonjeel qqum qʼoor	qummo's the way to the end of the world
#qum# Dentro de un año	A qué hora nos vamos al entierro	qum in the course of a year
#qum# Las frutas se ven grandes	Wu loʼn nmaq kkaʼyxik	qumate the fruit is a large
#qum# El cerdo tiene mucho piojo	Ri kuch xibʼal squkʼ chriij	qum the pig has a lot of saliva
#qum# El bebé no aguantó la fiebre	Ri lochʼ qal xchʼij ri qʼaaqʼ xelul chriij	qum, the baby could not bear the fever.
#qum# la señorita cuando viaja en carro le da vómito	Ri aliit ataq kbʼeek pchʼiichʼ kiryaʼ xaʼw chre	qum, when she travels by the car, is delivered.
#qum# La gente pelean por el agua	Ri winaq keʼchʼoʼ jnik chrij ri yaʼ	qum people fighting for water
#qum# Mi papá todos los días se mantiene ocupado	Ri wjow njeel qʼiij qal jamlik	qum, and is a workaholic.
#qum# En frente la iglesia	Chu wu jaay rech chʼabʼal kʼolik kʼeebʼ mulmik uleew	qumilie in front of the church
#qum# el árbol quedó atravesado en el camino	Ri cheʼ qʼeʼlik xk anjik pri bʼeey	qum the tree on the way.
#qum# El color de la oveja es medio negro	Ri chiij qʼeqqʼoj rkaʼybʼaal	qumle of the sheep is a half-black
#qum# Es necesario cuando tomamos el agua	Riliil riij ataq xtqum ri yaʼ nabʼeey xtrqowsxik	qum is necessary when drinking water
#qum# La fruta se endulza con los rayos del sol	Ri rwoch tikaʼ kkiʼyrik rum wu rtun qʼiij	qum's fruit will be sweet with the rays of the sun
#qum# La fruta del nopal tiene mucha espina	Ri rwoch nuxtaʼ xibʼal rkʼixil	qumla-bori-bori-bori-bori-bori-bori-bori-bori-bori-bori-bori-bori-bori-bori-bori-bori-bori-bori-bori-bori-bori-bori-bori-bori-bori-bori-bori-bori-bori-bori-bori-bori-bori-bori-bori-bori-bori-bori-bori-bori-bori-bori-bori-bori-bori-bori-bori-bori-bori-bori-bori-boribori-bori-bori-bori-bori-bori-bori-bori-bori-bori-bori-bori-bori-bori
#qum# La señorita c uida al bebé	Ri aliit kiryqʼuj ri ajkʼaal	qum's wife and baby
#qum# En el agua encharcada hay mucho zancudo	Chpom ri yaʼ piʼlik xibʼal xaʼn	qum in the water is much more
#qum# El perro ronronea cuando mira su	Ri tzʼiʼ ktzʼuʼynjik ataq kirkaʼyij wu rxoqʼjowil	qumayo The dog is gray when he is graying his
#qum# Cuando llegamos ya estaba abierto la	Ataq xojopnik jaqlik chik ri rchiʼ jaay jroq koʼkik elqʼoom	qumile, the door was already open.
#qum# El niño se enfermo de dearrea	Ri ajkʼaal xyabʼrik rukʼ xjir	qum (Quo) is the child being made sick by thirrre
#qum# Las hormigas comen la migaja de tortilla	Ri snik ktij ri rxiʼl leej	qumla, and the ants eat the tortilla-garut
#qum# Los que engalanan la fiesta son las bellas mujeres	Ri kiʼ wiqnik ri nima qʼiij areʼ ri qʼus laj taq ixoq	qum the feast by the beautiful women.
#qum# El durazno está desabrido	Ri traas spoqʼpoj rtijik	qumbar is open.
#qum# La sábila es bueno para las quebraduras	Ri wiqabʼaaq kchuknik chu ri qʼajaʼ	qum is good for ruphu.
#qum# El bebé ya no pudo mamar porque se le	Ri ajkʼa al qal chik xtuʼnik rum wu xsopjik wu rqul	qum'd the baby, because it made him
#qum# Todos los	Qonjeel wu ojkʼolik chu rwoch paxil nkareʼ xaq jnum ri qbʼanbʼaal	qumqumqumqumqumqumqumqumqumqumqumqumqumqumqumqumqumqumqumqumqumqumqumqumqumqumqumqumqumqumqumqumqumqumqumqumqumqumqumqumqumqumqumqumqumqumqumqumqumqumqumqumqumqumqumqumqumqumqumqumqumqumqumqumqumqumqumqumqumqumqumqumqumqumqumqumqumqumqumqumqumqumqumqumqumqumqumqumqumqumqumqumqumqumqumqumqumqumqumqumqumqumqumqumqumqumqumqumqumqumqumqumqumqumqumqumqumqumqumqumqumqumqumqumqumqumqumqumqumqumqumqumqumqumqumqumqumqumqumqumqumqumqumqumqumqumqumqumqumqumqumqumqumqumqumqumqumqumqumqumqumqumqumqumqumqumqumqumqumqumqumqumqumqumqumqumqumqumqumqumqumqumqumqumqumqumqumqumqumqumqumqumqumqumqumqumqumqumqum
#qum# El m uchacho mató una ardilla con su onda	Ri alaabʼ xwiʼtaj jun kuuk rukʼ ri r chʼaabʼ	qum the boy has killed a turtle with his wavel
#qum# La rodilla de mi hermano se quebró cuando le cayó un trozo encima	Ri rchʼeek wtziik xqʼajik ataq xtzaquul jun xaʼk chriij	qum, my brother broke his knee when a piece fell upon him.
#qum# El dor mitorio es limpio	Ri wurbʼal kchʼajchʼtik	qum's the Purge
#qum# El carro se fue directo al barranco	Ri chʼiichʼ suukʼ xbʼeek pswon	qum, the car drove directly into the ditch.
#qum# En el terreno hay varios muros	chpom ri uleew kʼiy kʼulbʼat ikʼolik	qumate the land, there are various walls
#qum# Una vez se dice que lo más importante es el respeto	Jumul xtbʼiʼxik ke ri qatz riliil riij areʼ ri nimneem	qum, and it is said that respect is the most important.
#qum# El caldo salió medio salado	Ri ryaʼl iik tzeytzoj xelik	qum is half-salted.
#qum# Cuando caminamos mucho los pies nos	Ataq kojbʼinik nim tʼuus keʼlik ri qqan	qum the ground, and when we run much we are
#qum# Cuando desaté la pita es fácil arrollar en un olote	Ataq xinsol ri kʼaam xinbʼotzʼ chrij jun piʼq	qum the fat, it is easy to crawl into an owl.
#qum# El chichicaste tiene mucha espina	Xibʼal rkʼixil ri yeel	qum a lot of the spine.
#qum# Para la fiesta trabajaron dos recepcionista	Pri nimaqʼiij xeʼchuknik kʼeebʼ ulanel	qum, and two receptionists worked for the feast.
#qum# A ellos les dieron el dinero para hacer la fiesta	Chke xyoʼqik njeel ri poq chi rbʼanik ri nimaqʼiij	qum, and they were paid for the party.
#qum# Mi sobrino es un buen hombre	Ri wkaaqʼ areʼ jun utz laj achii	qumqum is a good man.
#qum# El cuero estaá extendido en el suelo	Ri tzʼuu m likʼmaj rwoch chu uleew	qum is spread on the ground
#qum# Por estar	Rum wu qal tzʼqaat ri rpajbʼaal ri ajkʼeynel sichaʼ xbʼeek pcheʼ	qummqmqmqmqmqmqmqmqmqmqmqmqmqmqmqmqmqmqmqmqmqmqmqmqmqmqmqmqmqmqmqmqmqmqmqmqmqmqmqmqmqmqmqmqmqmqmqmqmqmqmqmqmqmqmqmqmqmqmqmqmqmqmqmqmqmqmqmqmqmqmqmqmqmqmqmqmqmqmqmqmqmqmqmqmqmqmqmqmqmqmqmqmqmqmqmqmqmqmq
#qum# El atol no se pudo tomar	Ri qʼoor qal xqumik kʼten xtewrsxik tekʼchi xjachik	qumle, and the atoll could not be taken.
#qum# Temascal	Ri wakx jurjik ri raaqʼ La vaca tiene la lengua larga	qummiq qʼoʼl qʼoqʼl
#qum# No es bueno prestar algo a alguien porque se adueña	Qal utz xtqyaʼ jun che chqoom ri wnaq kʼa krechbʼeej	qum to give something because it is his or her own.
#qum# El cuero que tiene el sentadero se	Ri tzʼuum ri kʼaʼn chu ri kʼuqulbʼal mixjarik	qumle, the skin that has the seat is
#qum# El hombre cuando siembra busca	Ri achii ataq kir bʼan ri awaʼn kertaqiij ajchaak chu rtoxik	qum, the man who strives to
#qum# La gallina clueca se mur ió	Xkmik ri tʼuq laj akʼ	qum on the wall the chicken is clicking on the wall
#qum# Mi mamá compró una servilleta	Ri nchuch xloqʼ jun suʼbʼal qʼabʼ	qum. my mother bought a towel.
#qum# es bueno regalar dinero pero a los huérfanos	Utz xtqsipaj ri poq nuʼj chke ri mebʼaʼ	qum, but to give to the orphans is good.
#qum# Mi casa es de color v erde	Ri wchoch rex ri rkaʼybʼaal	qumarin' my house
#qum# cuando hay nube en el cielo es seña que	Ataq kʼolik muuj chukaaj retal kʼchiʼ kpetik jabʼ	qumation of the sky, it is a sign that
#qum# Las crías de la marrana que cayero son hembras	Ri raal kuch xiʼ qajik tiʼt njeel	qum-b-b-b-b-b-b-b-b-b-b-c-b-b-b-b-b-b-b-b-b-b-b-b-b-b-b-b-b-b-b-b-b-b-b-b-b-b-b-b-b-b-b-b-b-b-b-b-b-c-b-c-b-c-c-b-cb-cb-cb-cb-b-cd-cb-cb-b-cb-cb-cb-cb-cb-cb-cb-b-cb-c-cb-cb-d-bb-d-cb-cb-b-d-cb-bb-cbb-b
#qum# mi mamá lo quemó su paleta	Ri nchuch xproj ri rtkuʼl	qum) was cremated by my mother.
#qum# La comida es bien ssabrosa	Ri rtibʼliil woy chetzʼini k rtijik	qum is very flavorful.
#qum# Cuando salimos al mirador el pueblo se mira bello	Ataq xojelpoon chu ri ilbʼal qʼus rkaʼyxik ri tinmit	qum, the village is beautiful.
#qum# El guisquil es bueno que	Wu chʼmaay utz xtktij ri ajkʼlobʼ rech xtkʼobʼik kchoqʼaabʼ	qumqʼ qʼoʼqʼqʼik
#qum# Cuando se reunieron los	Ataq xkmol kiibʼ ri aloʼm xkbʼanken jun etzlaal chu ri qtikaʼ	qumle the two of them.
#qum# Escuela	Ri wxqʼajlobʼ tarnuul chwij mi compañero viene atrás	qum (school)
#qum# La mujer muele la pepita de ayote en la piedra de moler	Ri ixoq kirjokʼ ri skiil chu kaʼ	qumilil the oatmeal in the oatmeal
#qum# El ajenjo es bueno para el dolor de estómago	Wu musmut utz chi qʼxom kʼuʼxaj	qum is good for stomachache
#qum# Mi abuel o posee grandes conocimientos	Ri n tatanool nim ri retambʼal	qum is a great knowledgeable
#qum# Escama	Don Jesus se puso la camisa al revés	qumqumqumqumqumqumqumqumqumqumqumqumqumqumqumqumqumqumqumqumqumqumqumqumqumqumqumqumqumqumqumqumqumqumqumqumqumqumqumqumqumqumqumqumqumqumqumqumqumqumqumqumqumqumqumqumqumqumqumqumqumqumqumqumqumqumqumqumqumqumqumqumqumqumqumqumqumqumqumqumqumqumqumqumqumqumqumqumqumqumqumqumqumqumqumqumqumqumqumqumqumqumqumqumqumqumqumqumqumqumqumqumqumqumqumqumqumqumqumqumqumqumqumqumqumqumqumqumqumqumqumqumqumqumqumqumqumqumqumqumqumqumqumqumqumqumqumqumqumqumqumqumqumqumqumqumqumqumqumqumqumqumqumqumqumqumqumqumqumqumqumqumqumqumqumqumqumqumqumqumqumqumqumqumqumqumqumqumqumqumqumqumqumqumqumqumqumqumqum
#qum# Pagar	Ri toch ʼaʼ kirtij ri rwoch nuxtaʼ el jilguero c ome la fruta de la tuna	qumate number
#qum# el árbol es frondoso y da buena sombra	Ri cheʼ pujpik sichaʼ kiryaʼ muʼj	qum that the tree is flowering and gives a good shade
#qum# Cuando construí mi casa tuve que hacer un préstamo	ataq xinbʼan ri wchoch xinbʼan jun jloom	qum, and I had to borrow money to build my house.
#qum# La comadreja tiene la cola larga	Ri saqtbʼiin jurjik wu rjey	qum, which is a long tail.
#qum# Por mucha carga el carro no aguantó salir en la subida	Kʼa xaq et rchim wu chʼiichʼ xichaʼ qal xchʼij xelbʼik chu wu rujyubʼ	qum, because of the amount of the load the carriage could not get off on the ascent
#qum# El trabajo que hace la mujer todos los	Ri rchak ri ixoq kirbʼan njeel qʼiij areʼ ri tʼisneem	qum the work done by the woman all
#qum# La tosferina le da a los niños	Wu jiiqʼ kiryaʼ che ri ajkʼalobʼ	qumla, and the child receives the toxpherin.
#qum# La señorita se ve elegante con sus collares	Ri aliit qʼus rkaʼyxik kukʼ ri ruwaj	qumée, the lady is elegant with her collar-bendered
#qum# Cuando terminó la	Ataq xkʼisik ri molbʼeem ri aloʼm xiʼ tikrook chu ktzʼulxik ri altom	qum, and so on.
#qum# La chicharra de pino tambien se usa	Wu chʼikaʼx xuqkee kchuknik chi siʼ	qumle the pine crumbs is also used
#qum# Semana	En el techo de la casa hay dos agujeros	qum The week-to-week
#qum# El trabajo quedó mal hecho por eso se	Ri chaak xaq che rbʼ anik sic haʼ xqtzuntzaj	qum is a poorly done work, so is
#qum# El hombre salió temprano a sembrar la	Aqʼabʼ xelbʼik ri achii chi rawxik ri chnooj	qumayo, the man went out early to the
#qum# Hay mucho miedo al asesino Ciprés	Xibʼal xibʼaliibʼ chu ri wiʼtnel	qum is a great fear of the Assassin of Cyprus.
#qum# a la señora se le quemó la piel de la mano	X kʼatik ri rtzʼumil rqʼabʼ ri ixoq	qum's skin in the hand.
#qum# Cuanto ascendió la cantidad del dinero	Jrubʼ rajlaal ri poq xeʼloq	qumomoqomoqomoqomoqomoqomoqomoqomoqomoqomoqomoqomoqomoqomoqomoqomoqomoqomoqomoqomoqomoqomoqomoqomoqomoqomoqomoqomoqomoqomoqomoqomoqomoqomoqomoqomoqomoqomoqomoqomoqomoqomoqomoqomoqomoqomoqomoqomoqomoqomoqomoqomoqomoqomoqomoqomoqomoqomoqomoqomoqomoqomoqomoqomoqomoqomoqomoqomoqomoqomoqomoqomoqomoqomoqomoqomoqomoqomoqomoqomoqomoqomoqomoqomoqomoqomoqomoqomoqomoqomoqomoqomoqomoqomoqomoqomoqomoqomoqomoq
#qum# Ya no hay venta porque se murió el dueño Bellota de arboles	Qaqchee chik ri k ʼ yeej kumu xchupik ri rxoqʼjowil	qumile , there is no sale , because the owner of trees , Bellota , has died .
#qum# La mujer fue a buscar hongo en la	Ri ixoq xbʼeek chi rtaqxik qʼaʼtzuy praal cheʼ	qum, the woman went after a pillow in the
#qum# De día ent raron los ladrones en la casa a robar	Paqʼiij xoʼkik ri elqʼoom pjaay elqʼnel	qum the day the thieves came to the house to steal
#qum# Nuestro camino se	Ri qbʼey xsukʼbʼik kumu xqjnumsaj ri qchoqʼaabʼ	qumqumqumqumqumqumqumqumqumqumqumqumqumqumqumqumqumqumqumqumqumqumqumqumqumqumqumqumqumqumqumqumqumqumqumqumqumqumqumqumqumqumqumqumqumqumqumqumqumqumqumqumqumqumqumqumqumqumqumqumqumqumqumqumqumqumqumqumqumqumqumqumqumqumqumqumqumqumqumqumqumqumqumqumqumqumqumqumqumqumqumqumqumqumqumqumqumqumqumqumqumqumqumqumqumqumqumqumqumqumqumqumqumqumqumqumqumqumqumqumqumqumqumqumqumqumqumqumqumqumqumqumqumqumqumqumqumqumqumqumqumqumqumqumqumqumqumqumqumqumqumqumqumqumqumqumqumqumqumqumqumqumqumqumqumqumqumqumqumqumqumqumqumqumqumqumqumqumqumqumqumqumqumqumqumqumqumqumqumqumqumqumqumqumqumqumqumqumqum
#qum# C uando cayó el niño le salió sangre en la nariz	Ataq xtzaqik ri ajkʼaal xelul kikʼ pirtzaʼm	qum, and a blood vessel from the nose was
#qum# El retrato es algo que nos recuerda	Ri wochbʼlaal areʼ jun naʼtbʼal qe	qum is something that reminds us of the
#qum# Cuando hay mucho aire el techo de la casa	Ataq xi bʼal kqʼiiqʼ ri rwiʼ jaay ktzalbʼik	qum, and when there is plenty of air, the roof of the house is
#qum# La cria de la oveja lo amamantan porque	Ri raal chiij ktuʼnsxik kumu qal xpon rqʼij	qumile the lamb, because the lamb is pulled
#qum# El gato de monte se comió todos los pollitos	Ri yaak xeʼrtij ri raa l akʼ	qum the wildcat has eaten all the chickens.
#qum# La	Ri rkʼoʼxiil ubʼooy kchuknik chu awbʼal	qumle the way of the world's
#qum# A la muchach a no se le nota que es tartamuda	Ri aliit qal kirkʼut saqsi tzʼeebʼ	qum, and the girl does not realize that it is blunt.
#qum# El hombre mató el venado con su	Ri achii xrubʼaaj ri musaat rukʼ ri ubʼ al	qumlo, and the man has the rock with his
#qum# la puerta de la casa se partió por el temblor	Ri rchiʼ jaay xpaqʼtjik rum ri rkabʼ rqan	qum the door of the house was shattered by the earthquake.
#qum# Mi hernana tiene gemelos	Ri wnobʼ yuux ri raal	qumr qrqqqqqqqqqqqqqqqqqqqqqqqqqqqqqqqqqqqqqqqqqqqqqqqqqqqqqqqqqqqqqqqqqqqqqqqqqqqqqqqqqqqqqqqqqqqqqqqqqqqqqqqqqqqqqqqqqqqqqqqqqqqqqqqqqqqqqqqqqqqqqqqqqqqqqqqqqqqqqqqqqqqqqqqqqqqqqqqqqqqqqqqqqqqqqqqqqqq
#qum# Al perro le dio fiebre	Ri tzʼiʼ xelul qʼaaqʼ chriij	qum, the dog has been receiving a fever.
#qum# El anciano ya no aguanta afeitarse	Ri tatyoox qal chik kirchʼij rjoʼxik ri rsomchiʼ	qum, the old man can no longer shave his hands.
#qum# Todos los trabajadores les pusieron a	Njeel ri ajchaak xeʼyoʼqook chu rpaqʼik ri uleew	qumeth them all the workers
#qum# T odos los trabajadores ayudaron para juntar la	Njeel ri ajchaak xeʼtobʼik chu rmolik ri abʼaj	qumle the work of the workers, who helped
#qum# La tierra se tiene que compactar bien	Wu ulee w naʼl xtzʼaqik	qum to the earth's surface, and the earth's crust must be well
#qum# El gato le dió un mordisco al pan	Ri wix kir qchʼuj ri paan	qum the cat gave the bread a bite
#qum# Cerrado	Ataq xojelbʼik qonjeel x qtzʼap ijken ri rchiʼ jaay	qumqumqumqumqumqumqumqumqumqumqumqumqumqumqumqumqumqumqumqumqumqumqumqumqumqumqumqumqumqumqumqumqumqumqumqumqumqumqumqumqumqumqumqumqumqumqumqumqumqumqumqumqumqumqumqumqumqumqumqumqumqumqumqumqumqumqumqumqumqumqumqumqumqumqumqumqumqumqumqumqumqumqumqumqumqumqumqumqumqumqumqumqumqumqumqumqumqumqumqumqumqumqumqumqumqumqumqumqumqumqumqumqumqumqumqumqumqumqumqumqumqumqumqumqumqumqumqumqumqumqumqumqumqumqumqumqumqumqumqumqumqumqumqumqumqumqumqumqumqumqumqumqumqumqumqumqumqumqumqumqumqumqumqumqumqumqumqumqumqumqumqumqumqumqumqumqumqumqumqumqumqumqumqumqumqumqumqumqumqumqumqumqumqumqumqumqumqumqum
#qum# El bastó n de mi abuelo se quebró	Ri rchʼmeʼy ntatanool xq ʼajik	qum the threshold of my grandfather's staff.
#qum# La hamaca está hecha de pita de mecate	Ri abʼaʼ bʼantlik rukʼ saqkiiy	qum is made from ground pepper.
#qum# ¿cuándo?	¿Cuánto cuesta el sombrero que compró mi mamá en la plaza	"qum"" - ""What is it?"""
#qum# El hombre salió con su perro a cazar	R i achii xelbʼik rukʼ ri rtzʼiʼ chu rtaqxik ri musaat	qum-qum-qum-qum-qum-qum-qum-qum-qum-qum-qum-qum-qum-qum-qum-qum-qum-qum-qum-qum-qum-qum-qum-qum-qum-qum-qum-qum-qum-qum-qum-qum-qum-qum-qum-qum-qum-qum-qum-qum-qum-qum-qum-qum-qumqum-qumqumqum-qumqumqum qum-qumqum-qum-qumqumqumqum qum qumqum-qumqumqumqqumqumq qum-qumqumqumqumq
#qum# El ratón ensuscio todo el maíz fracción/ pedazo	Ri chʼooy xchʼulchʼaʼ ri ixiim	qum's mouth is the whole of the rotten piece of corn/part
#qum# Toda la gente tienen buena ineligencia por eso están bien	Njeel ri wnaq nim ri knoʼj sichaʼ utz ikʼolik	qum all men have a good unequal, so they are good.
#qum# Mi mamá tuvo que	Ri nchuch xtzaltzaj ri poʼt ri xloqʼ kumu nuchʼ xkanaj chriij	qum (b) m'mother had to
#qum# La Guayaba se da en los barrancos	Ri keqʼ kiryaʼ ptaq ri rqan swon	qumla qʼoʼl qʼoʼl qʼoʼl qʼoʼl qʼoʼl qʼoʼl qʼoʼl qʼoʼl qʼoʼl qʼoʼl qʼoq qʼoʼl qʼoʼl qʼoʼl qʼoʼl qʼoʼl qʼoʼl qʼoʼl qʼoʼl qʼoʼlqʼoʼl qʼoʼl qʼoʼl qʼoʼl qʼoom qʼoomik qʼoʼoʼl qʼoʼl qal qal qal qal qal qal qal qal qal qal qal qal qal qal qal qal qal qal qal qal qal qal qal qal qal qal qal qal qal qal qal qal qal qal qal qal qal qal qal qal qal qal qal qal qal qal qal qal qal qal qal qal qal qal qal qal qal
#qum# Los c erdos ensuciaron la comida	Ri kuch xkchʼulchʼaʼ ri kwoy	qum has spoiled the food the deserts
#qum# Bejuquillo	Cuando oímos el río tumbar rápido corrimos	qum-shaped orange
#qum# Hoy va llover con granizo	Ajwiʼ xtpetik jabʼ rukʼ saqbʼuch	"qumle: ""Today it is raining with snow"
#qum# El perro se revolcaron con el coyote	Ri tzʼiʼ xkbʼalktij kiibʼ rukʼ ri sjiʼl	qum the dog with the Coyote.
#qum# Es necesario cuando amanecemos debemos agradecer a Dios	Riliil riij ataq xkojwaʼljik xkojtyoxnik chu Ajaw	qumile, and so on.
#qum# Me duele el oído	Kqʼoxwik ri nxkin	qumme in the ear.
#qum# Mi perro está acostumbrado comer chile	Ri ntzʼiʼ naqʼtlik kirtij iik	qum, and it is my dog's farewells in chili.
#qum# En los barrancos se da mucho el helecho	Ptaq ri rqan swon kiryaʼ xibʼal ri chibʼaʼ	qum in the gutters there is plenty of corn
#qum# El sastre fue matado por los ladrones	R i ajtʼisnel xwiʼtxik kum ri elqʼoom	qum, and the tailor was killed by the robbers.
#qum# El maestro dice a los estudiantes que guarden	Ri ajtiij xbʼ iij chke ri ajtijnel kʼotz kixkʼ olaq	qumedici, and the teacher tells the students to be careful.
#qum# Cuando le fueron a encontrar a la mujer la	Ataq xeʼriqtjaq ri ixoq juplik bʼanmajken chre	qumile, and when they found the woman
#qum# Camarón	La orina apesta mucho cuando hay mucho calor	qum-qamarun
#qum# Mucha diversión se hizo en el parque	Nim ri kaʼy kbʼanik chu ri waʼktbʼal	qum) There was a lot of fun in the park.
#qum# El regaño es bueno enseñarles a los niños	Ri yaaj utz xttijxik chke ri ajkʼlobʼ	qumilika is good when you teach kids how to
#qum# La ardilla se terminó de comer los elotes	Wu kuuk xkʼis ri a j chtijik	qum the Elot was eaten by the turtle.
