input	reference	prediction
#qum# La esposa de don Jesus solo utiliza buena leña	wu rxqiil taʼ xuux xaq utz laj siʼ kchuknik chre	qum ri xtzʼiʼ rbʼal
#qum# Todo la arveja se	Njeel ri xkarawaʼn xpochʼik rech chenim xchaqʼjik	qum kʼoʼbʼal
#qum# En nuestro pueblo ya no se usa nuestro idioma	Pri qtinmit qal chik kchkunsxik ri qyolbʼaal	qum ri ri xʼoʼbʼal ri xbʼaʼ
#qum# El estudiante está aprendiendo como	Ri ajtijnel tjin kirtijuuj c hemo rchkunsxik ri suʼ	qum ri xtzʼiʼbʼal xkʼoʼ
#qum# La mujer estaba abrazada por su marido	Ri ixoq tzʼulmaj rum ri rchjiil	qum ri xkʼal xbʼal
#qum# Mañana van a sembrar con don Francisco	Rukʼ taʼ Francisco chwaʼq xtbʼanik awaʼn	qum rkʼal xbʼal
#qum# Alrededor de la casa hay un cerco	Chwoch ri jaay kʼolik jun tzʼapiibʼ	qum ri xʼiʼ xtzʼiʼl
#qum# Ataq	Los jóvene s todos los días juegan en el campo Perjuicio	qum ri xqʼiʼl
#qum# Cuando murió mi mamá me quedé en la tristeza	Ataq xchupik ri nchuch xinkanajken pri bʼiis	qum ri rqʼ xbʼiʼl ri xtʼoʼl ri rbʼal
#qum# la mujer se murió de la matriz	Ri ixoq xchupik rum wu rchuch rkʼuʼx	qum ri rʼiʼ r rkʼijbʼ
#qum# Entre tres días nos encontramos para platicar del	Oxej xtqriq qiibʼ chi ryolik ri chaak	qum ri rkʼal ri xkʼiik
#qum# A los niños no es bueno enseñarles a	Chke ri ajkʼ a lobʼ qal utz xtnaqʼsxik ri elqʼneem	qum ri xtzʼalbʼij
#qum# La hoja de aliso es bueno para la broza	Ri rxaq limobʼ utz kchuknik chi ri qʼyees	qum ri xbʼal ri ri xbʼal riʼ
#qum# El caballo se cayó por mucha carga	Ri keej xtzaqik rum wu xaq et rchim	qum ri ri xtʼoʼl
#qum# El bebé resbaló en la cascara de la fruta	Ri ajkʼal kjilpji k pri riij loʼn	qum ri xʼoʼ xqʼuʼ ri xtzʼbʼikʼ
#qum# El señor le dejo toda la tierra a su nieto	Ri tatyoox xyaʼken njeel ri uleew chu ri rmon	qum ri rxbʼal
#qum# Los zapatos de la señorita les quedo flojo Jaula	Wu xjabʼ koʼl xiʼ kanajken pirqan wu aliit	qum ri xtʼal ri xtqʼal
#qum# La comadreja se terminó de comer las gallinas	Wu saqtbʼiin mixeʼrkʼis ri akʼ c htijik	qum ri rbʼiʼ xtʼoʼ
#qum# Cuatro mesas grandes servirán para comer	Kji bʼ nmaq meex xkiʼchuknik rech weʼbʼal	qum ri rʼbʼal xbʼal
#qum# Todos los lapiceros ya están divididos a los niños	Njeel ri tzʼibʼbʼal jachmaj chik chke ri ajkʼalobʼ	qum xkʼoʼn ri xkʼabʼal
#qum# La mata de aguacate se está secando por el	Ri rqan ooj tjin rchiqik rum wu tzrabʼ	qum ri xtzʼal xbʼal
#qum# Cuando bajamos a la orilla del río es muy	Ataq kojqajbʼik chchiʼ ri yaʼ xibʼal kliswik	qum ri xqʼoʼ ri xbʼaʼl
#qum# El hombre cuando	Ri achii ataq kirbʼsuj rbʼanik jun chaak, xtbsuj ri qʼiij chu rkʼisbʼaal	qum ri xʼoʼbʼal ri ajbʼal
#qum# La cara de la vaca se ve alargada	Tzʼajtzʼik rkaʼyxik ri rwoch ri waakx	qum ri rkʼbʼal ri rqʼuʼ
#qum# La araña come las moscas que están en la pared	Wu am kertij ri us ri ikʼoʼk chu xaan	qumʼal xkʼaʼbʼal xbʼal xbʼal
#qum# Kkanjik	Ataq kpetik nim jabʼ xibʼal ri senyabʼ	qumqʼ xbʼoʼn
#qum# mi papá tiene muchos parientes por eso no se mantiene en la casa	Ri wjow kʼiy richlaal sichaʼ qal kkʼuqbʼik chjaay	qum ri xʼoʼl ri xtzʼal
#qum# Vejez	Ataq kpetik jabʼ njeel ri qʼoos krexbʼik	qum ri riʼ xtzʼal riʼ rkʼoʼ
#qum# Todo el maíz se apolillo	Njeel ri ixiim xpokʼrik	qum ri xtʼikʼbʼal ri xtʼiʼ
#qum# por el daño que el hombre está	Ri uleew tjin rmeqʼik rum wu kʼex ri tjin kirbʼan ri achii chre	qum wu rʼiʼ xbʼaʼ rkʼal
#qum# La masa salió quebrada	Ri qʼoor chqaam xelul	qum ri xbʼoʼ xbʼal ri xbʼal
#qum# La botella se utiliza para guardar miel	Ri limeet kchuknik chi r kʼolik ri ryaʼl chʼoxiʼ	qumʼ xkʼiʼ xbʼoʼ
#qum# Vamos todos para que nos atieden nuestra	Joʼ qonjeel rech xkojtaʼtjik che ri qajbʼeej	qum xʼiʼ xtzʼiʼ xbʼiʼ
#qum# El río creció por eso se llevó toda la	Ri nimaya ʼ xkʼiyik sichaʼ xuʼrmaʼ njeel ri tikaʼ	qum xtʼal xbʼoʼbʼ
#qum# El árbol es grandicimo por eso le pego el rayo	Jomom ri cheʼ sichaʼ xkʼeq rquljaay	qum xqʼoʼl ri xbʼal
#qum# El frijol que se compra en la plaza lo	Ri knaqʼ ri kloqʼik pkʼeybʼal esmaj jun pajbʼal	qum xʼoʼbʼal xkʼoʼ ri rxbʼal
#qum# Cuando cómo frijol me da ardor de pecho	Ataq kintij knaqʼ kiryaʼ qʼaʼteew chwa	qum xqʼoʼl ri xbʼal
#qum# Todas las frutas están rodajeada con cuchillo	Njeel wu loʼn jexmaj rukʼ qʼatbʼal	qumʼ ri rʼan ri xtʼiʼ rbʼaj
#qum# Ayer mi mamá compró hilo de varios colores	Iwir ri nchuch xloqʼ bʼatzʼ pkʼeybʼal jaljoj kkaʼybʼaal	qum ri xkʼoʼ xtʼiʼ
#qum# El ladrón fue arrastrado por las	Ri elqʼoom xqitxik kum ri wnaq xaq rum wu xrelqʼaaj jun keej	qum xtʼiʼj xtzʼajbʼ
#qum# Las matas de maguey se están secando por la plaga	Ri rqan kiiy tjin rchiqik rum wu xoʼkik chkop txeʼ	qum ri ajʼik ri xkʼbʼal ri ri ri rkʼij
#qum# Cuando se come un chompipe quiere mucho	Ataq ktijik jun chooj nim rkunaal kraaj	qumʼ rkʼoʼbʼal
#qum# Todo el techo de ,la casa gotea	Njeel ri rwiʼ jaay ktzʼujik	qum xbʼal xbʼiʼj
#qum# Quemar bien	El enfermo se empeoro porque salio bajo la lluvia	qumʼ rxʼiʼj
#qum# La reun ion se realiza cada semana	Ri molbʼeem kbʼanik chwuqubʼ qʼiij	qum ri xʼiʼl xtzʼ ri rkʼiʼ
#qum# El árbol se le seco las hojas	Ri cheʼ xchiqik ri rxaq	qum riʼ ri xkʼuʼl ri rkʼik
#qum# Con el doblador se hacen muñecas decoradas	Rukʼ wu joʼq keʼ bʼanik qʼus laj alaʼs	qum ri rkʼiʼ rbʼik ri xbʼaʼ
#qum# el coyote se comió l as once ovejas	Julajuuj chiij xeʼr tij ri sjiʼl	qum rkʼik xtzʼbʼal
#qum# El hombre se go lpeó la	Ri achii xkʼoxbʼsaj ri rjlom ataq xtzaqik rukʼ ri jochlan chʼiichʼ	qum xqʼal xbʼal xbʼal
#qum# El frujol blanco es delicioso comer en	Ri knaqʼ saqtbʼin chetzʼiʼnik rtijik pjkʼom iik	qum rʼ ri xqʼuʼ rqʼoʼn
#qum# L avado	El cerdo ensució el maíz	qum xkʼoʼn xbʼaʼ ri xkʼoʼ
#qum# La mujer hace lasos con la	Ri ixoq kiʼrbʼan ri klobʼ rukʼ ri saqkiiy ri kirbʼan rukʼ ri choʼl	qum xbʼoʼl ri rxbʼal
#qum# El ayote es bien rico pa ra comer	Chetzʼiʼnik rtijik ri qʼooqʼ	qum ri ri xʼoʼbʼal
#qum# Cerca murió el marido de la mujer	Nqaaj waʼchiʼ xchupik ri rchjiil ri ixoq	qum xtzʼal
#qum# Todo el tamal estaba comido por las ratas	Njeel ri subʼ tijmaj rum chʼoo y ataq xojsaqrik	qum riʼ ri xkʼuʼ xkʼoʼ
#qum# Arena	Ataq kiʼjikxik ri cheʼ ri uleew sbʼajbʼoj kkanjik	qum ri xbʼajbʼal xbʼal
#qum# El formón lo utiliza el carpintero	Ri tzʼqubʼ kchuknik chu ri jsol cheʼ	qumʼ ri xkʼal xkʼal
#qum# El conejo cuando hay buena luna sale a comer el frijol	Ri imul ataq kʼolik rqan iikʼ kelul chirtijik wu knaqʼ	qum ri xtzʼ ri xbʼoʼ
#qum# La mujer cuando mató a la gallina	Ri ixoq ataq xwiʼtaaj ri akʼ kʼa xlechʼpij ri rtzʼumil	qum ri riij ri rbʼal
#qum# El documeto del terreno está ahumado	Ri rjujil uleew xsibʼrik wu riij	qum riʼ ri xbʼal xbʼaʼl ri xbʼaʼ
#qum# La flor de milpa lo come las chorchas	Ri tzʼtuj ktij tochʼaʼ chu kwoy	qum xtxoʼl xtzʼal xtzʼiʼ
#qum# Es necesario cuidar la naturaleza	Riliil riij xtloqʼxik ri uleew	qum ri xtzʼal xbʼal
#qum# La mayoría de los niños consumen mucha galguería	Ri knimalil ri ajkʼalobʼ ktij tzʼiʼlil	qum rqʼikʼ rxbʼal
#qum# Cuando entra el verano las vacas se ponen flacos	Ataq kokik saqʼiij yaax keʼlik ri waakx	qum ri ri xtzʼik ri rkʼal ri ri rkʼik
#qum# El niño se majó el dedo	Ri ajkʼaal xwochʼ wu rwiʼ rqʼabʼ	qum ri xʼaʼn xbʼal ri xbʼal
#qum# Boca arriba	Ri nchuch xloqʼ ri paa kʼ pkʼeybʼal	qum xʼaʼ ri rxbʼal
#qum# El niño no guantó porque se le regó agua	Ri ajkʼaal qal xchʼij kumu kʼten yaʼ xtixuul chriij	qum xtxbʼal xkʼuʼ ri ri ri xbʼajbʼ
#qum# La mariposa vuela entre las flores	Wu puʼt kxikʼnik chu taq ri kotzʼaj	qum ri xkʼoʼl ri riij
#qum# Todos los enfermos sanaron	Njeel ri ya abʼ mixuʼtzrik	qum ri xbʼal xbʼal
#qum# La milpa se secó porque le cayó hielo	Ri chnooj xchiqik kumu xqaaj teew chriij	qum ri ri ri xtzʼik ri xbʼal
#qum# El frijol amarillo da cuando se siembra	Ri xpley kiryaʼ ataq jnum kawxik rukʼ ri chnooj	qum ri xbʼiʼ xtʼiik ri rbʼbʼal
#qum# El agua tiene pureza	Ri yaʼ kʼolik rsaqiil	qum ri xtxʼal xtxʼbʼal
#qum# El techo de la casa de mi papá se ve de forma triangulo	Jutzʼjik rkaʼxik ri rwiʼ rchoch wjow	qum riʼ xbʼiʼbʼal
#qum# Cuando el buhuo llega a	Ataq koʼqʼoʼk ri toltol chjaay labʼnel kʼolik chinaq xtkmik	qum xkʼoʼl xkʼoʼbʼal
#qum# La reunión de los estudiantes se hizo anteayer	Ri molbʼeem kech ri aj tijnel xbʼanik kabʼjiir	qum ri xqʼoʼbʼal ri xbʼalʼ
#qum# Mi mamá tiene sirvienta	Ri nchuch kʼolik rmkoom	qum ri xtʼal ri xtzʼal
#qum# Los niños empezaron a llorar cuando perdieron	Ri ajkʼalobʼ xeʼoqʼik rum qal xkchʼak ri etzʼnim	qum xtxʼool xbʼaʼ
#qum# Nuestro idioma es el Sipakapense	Ri qyolbʼaal areʼ ri Sipakapense	qum ri xbʼal xbʼajbʼal
#qum# Por un poco no alcanzo el fuego la otra casa	Xaq qiʼn chik qal xmaj qʼaaqʼ ri jun jaay chik	qum xbʼaʼbʼal
#qum# El mal de ojo les afecta a los	Ri rbʼaqʼ rwoch wnaq kirbʼan kʼex chke ri ajkʼ a lobʼ	qum ri xbʼiʼjbʼal
#qum# No es bueno comer el sobrante al otro día	Qal utz xtqtij ri chʼqaap	qum ri xbʼal ri xbʼal ri xbʼal
#qum# A todas las	Chke njeel ri wnaq xbʼiʼxik ke qal xeʼlbʼik xkoybʼeej ke xkʼisik ri molbʼeem	qum ri xbʼiʼbʼal ri xbʼal
#qum# Para la fiesta del pueblo todos damos la contribución Ri achii xkanajken	Rech ri nima qʼiij rech tinmit qonjeel qyaʼ ri kchuuj	qum xbʼal xbʼan xbʼal xbʼal
#qum# Todo el trabajo que se realizó estaba bien pensado por eso salió bien	Njeel ri chaak ri xbʼanik bʼusmaj riij sichaʼ utz xeʼloq	qum ri xbʼiʼbʼʼal
#qum# Por allá está la casa de mi hermana	Tukkilaʼ kʼolik r i rchoch ri wnobʼ	qum ri xqʼij xkʼal
#qum# Las flores que tiene sembrado mi mamá son de color rojo	Njeel ri kotzʼaj ri rawmaj ri nchucch keq rkaʼybʼaal	qum xqʼiʼ xbʼajbʼ
#qum# Los trabajos de los antiguos ya no se encuentran	Ri kchak ri ojor wnaq qaqchee chik kiʼ riqt jik	qum riʼ ri xʼoʼl ri xbʼaʼ
#qum# El granizo golpeo la milpa	Ri saqbʼuch xkʼoxbʼsaaj ri chno oj	qum riik ri xbʼal riij
#qum# Al niño le da estornudo	wu ajkʼaal kiryaʼ achyam chre	qum xbʼal
#qum# Codo	Pongale una cuña a la mesa	qum ri xbʼal xbʼal xbʼal
#qum# Salimos rápido por eso regresamos juntos	Cha niim xojelbʼ ik sichaʼ xojtz aljuul jnum	qum ri xbʼal
#qum# El lápiz del estudiante se quebró	Ri rtzʼibʼbʼaal ri ajtijnel xqʼeptjik	qum xtzʼoʼn xbʼal xkʼoʼ
#qum# El cabello de la señorita está trensado con su	Ri rwiʼ ri aliit pochʼmaj rukʼ ri rxqʼap	qum ri xʼiʼ rqʼij
#qum# Ante el juez no se presentó el acusador	Chu ri qʼtal iil qal ri tzujnel xopnik	qum ri xbʼoʼbʼal ri rbʼal
#qum# C ama wu chʼaat bʼantlik rukʼ	Estaba mojado la camisa del hombre por eso le dio fiebre	qum ri xbʼoʼl ri xbʼal
#qum# El hom bre tiene bellos en el pecho	ri achii kʼolik rsmaal chu rkʼuʼx	qumqʼ ri xkʼoʼl ri ri xkʼbʼal
#qum# Pizarron	La tabla es ancha	qum riʼ xtxʼoʼn
#qum# El bebé gatea en el patio de la casa	Ri neʼ kchaknik pirqan jaay	qum qʼiʼ ri ri rbʼal ri xbʼaʼ
#qum# Hay personas que ya no se recuerda de	Kʼolik wnaq qal chik knaʼtaj ri kbʼanbʼaal chke	qum ri rkʼoʼl kʼoʼl ri xtzij
#qum# La señora ronca mucho cuando duerme	Wu ixoq kjororik wu rtzaʼm ataq kwrik	qum ri ri xchʼoʼ xbʼʼoʼ
#qum# La hoja de papel esta medio pegado	Ri rxaq juuj xaq qiʼn nakʼlook	qum ri xtzʼal
#qum# La gente cando existe entre ellos un problema se desprecian	Ri wnaq ataq kʼolik jun chʼoʼj chkxoʼl ketzlaj kiibʼ	qum ri ri xqʼiʼl ri xbʼal
#qum# El encendedor sirve para juntar el	Ri tʼiqbʼal kchuknik chu rnukʼik ri qʼaaqʼ	qum xtzʼal xbʼoʼn
#qum# Cuando se junta	Ataq kmo lik ri knaqʼ kʼolik rkʼolbʼaal waʼchiʼ kyoʼqqaj wiʼ	qum riʼ xtzʼal ri rbʼal
#qum# Donde yo vivo es tierra caliente	Ri waʼchiʼ kʼo ri wchoch mqʼen jyubʼ	qum ri ri rʼbʼiʼ ri xbʼaʼbʼal
#qum# C uando amanecemos el gallo canta	Ataq kojsaqrik ri tzeek koqʼik	qum ri rʼiʼ rbʼiʼl xtʼal
#qum# Todas las bancas son redondas	Njeel ri teem isetsik	qum xbʼal xbʼal xbʼaʼl
#qum# Cuando se tapisca la	Ataq kjachʼik ri jal xaq xeew ri rqan chnooj kkanjik	qum rʼiʼbʼal xbʼanqʼ
#qum# La masa salió fino en el molino	wu qʼoor kookʼ xelul pwu keʼbʼal	qumq riij xkʼuʼl ri ri rkʼbʼal
#qum# Ri ixoq	Tráigalo	qum ri xkʼuʼl ri kʼaʼl ri xtzʼal
#qum# La escuela cumplió el decimo sexto año de	Rwaqlaaj rjnobʼ ri tijbʼal xtzʼaqtik	qumqʼ ri ri r rbʼajbʼal ri ri rqʼij
#qum# La fruta está medio ácido	Ri loʼn chʼomchʼoj rtijik	qum xtzʼiʼl ri xtzʼal
#qum# Los zapatos de mi abuelo es de color negro	Ri rxjabʼ ntatanool qʼeq kkaʼybʼaal	qum ri rʼiʼ rbʼʼaʼ rchʼbʼal
#qum# Todas las hojas de papel se perforó	Njeel ri rxaq juuj xeʼ worik	qum riʼ riʼ xbʼal
#qum# La vaca es de mejilla gorda Extendido	Ri waakx lewlik wu rwoch	qum ri xkʼoʼj ri xkʼij
#qum# Para espantar a los zanates sirve la onda de pita	Chu kxibʼxik ri chʼok kchuknik ri ixkeeqʼ	qum ri xʼalqʼal
#qum# Todos los niños se dispersaron por el miedo	Njeel ri ajkʼalobʼ xiʼ tuknik rum xibʼal kiibʼ	qum xtqqʼuʼl
#qum# El hombre ya es viejo por eso no aguanta caminar	Ri achii riʼj chik sichaʼ qal kirchʼij kbʼinik	qum ri xʼij xtzʼal
#qum# Es necesario mostrar lo que se quiere	Riliil riij xtkʼutik ri kajwxik rbʼanik kukʼ ri wnaq	qum xbʼiʼ ri xkʼiʼbʼal
#qum# La	Ri yuʼtz kʼebʼ muul xchuknik sichaʼ kamulbʼal rbʼiʼxik pqyolbʼaal	qum rʼiʼ rkʼiʼ r rkʼal
#qum# La tortuguilla terminó de comer el frijol	Wu leem xkʼis ri knaqʼ	qum riʼ ri xʼijbʼal
#qum# L a haba se muele para pinol	Wu jaws kkeʼxik chu kʼej	qum qʼoʼl xtzʼal
#qum# El trabajo está duro por eso no avanzaron los trabajadores	Wu chaak kow sichaʼ qal nim xkbʼan ri ajchaak	qum ri ri xkʼik ri xbʼajbʼ
#qum# La olla grande es de boca grande	Wu nima xbʼoʼj leʼlik wu rchiʼ	qum kʼook ri ri xtzikʼ
#qum# La abuela le duele su hueso	Ri nooy kiʼ qʼoxwik ri rbʼaqil	qum rkʼal ri xkʼoʼbʼal
#qum# Mi perro se murió despacio ór la vejez	Tkaal xkmik ri ntzʼiʼ rum riʼjaal	qum ri xkʼan xkʼoʼl
#qum# En la reunión llegaron solo dos mujeres	Pri molbʼeem xaq kʼeebʼ ixoq xoʼpnik	qum ri ri xʼoʼl ri rkʼiʼ ri rbʼiʼ
#qum# Si hablamos con la verdad	Saqsi xkojyolwik chqatziij rtqriq kʼchiʼ ri utziil	qum xbʼal xbʼaʼbʼal
#qum# En el terreno hay montones de piedras	Pri uleew kʼolik kʼiy amluʼx abʼaj	qum xtʼiʼ ri ri rkʼbʼal
#qum# Para que no nos critiquen es bueno pagar la deuda	Rech qal xkojyolik, utz xttojik ri kʼaas	qum ri xkʼalbʼal ri xkʼuʼ
#qum# Las aguas estancadas no es bueno	Ri tikʼlik yaʼ qal utz kumu kiʼ poqʼnik ri raal us	qum rkʼoʼn ri rbʼiʼl ri xkʼoʼl
#qum# El perro es travieso	Ri tzʼiʼ xwos	qum ri rqʼiʼ ri rkʼiʼ
#qum# Existen personas que no creen en las imágenes	Kʼolik ri wnaq qal knmaj ri tyoox	qum ri xkʼoʼbʼal
#qum# Que fecha nació mi hermano	Che rajlbʼaal rkʼosbʼik r i wtziik	qum ri xtʼal xbʼal
#qum# M i mamá está enfermo de la tos	Ri nchuch yaabʼ rukʼ rqul	qum ri xqʼoʼbʼal xbʼaʼ
#qum# la comadrona vive en el traingulo	Ri ajkuun tlaʼ kʼolik rchoch waʼchiʼ rbʼiʼ oxchʼuʼk	qum ri ajʼbʼal kʼajbʼal
#qum# La gall inaza es bueno para abonar la siembra	Ri rchaq akʼ utz xtqajik chxeʼ ri tikaʼ	qum ri xkʼoʼl ri xkʼoʼn
#qum# Cuando hay charcos de agua	Ataq kʼolik yaʼ tikʼlik xibʼal serat kiʼpoqʼnik	qum rʼiʼ ri xbʼaʼbʼaʼl ri xbʼaʼ
#qum# El ladrón entró arriba por eso no se dio cuenta el perro	ajsik xokul ri elqʼoom sicha ʼ qal xnaʼ ri tzʼiʼ	qumʼbʼaʼ ri xbʼaʼ
#qum# Cuando nacio el niño lo	Ataq xkʼosbʼik ri ajkʼaal rbʼaqʼtmaj riibʼ ri rkʼamaʼl rmuux pirqul	qum ri xkʼoʼj ri xbʼeel
#qum# El caballo tiene los ojos grandes	Ri keej bʼilbʼik wu rbʼaq rwoch	qum rtqʼal xtzʼik
#qum# Barrendero	El cuarto lo han barrido	qum riʼ xbʼalbʼal
#qum# Mi mamá puede hacer petate	Ri nchuch utz keʼrbʼan ri xkulbʼal	qum rqʼbʼaʼ r rkʼiik
#qum# La en voltura del papel está hecho de algodón	Ri pisbʼal ri juuj bʼantlik rukʼ miit	qum ri rqʼbʼal ri rbʼal ri rbʼal
#qum# Todos los negocios están cerrados	Njeel ri kʼyeej itzʼaplik	qum ri xtzʼal ri rkʼij
#qum# Dirrecion	Xsqarsxik ri riil ri achii se aclaró el delito del hombre	qum miʼ riʼ ri ri riʼ ri
#qum# En el camino se regó arena	Chpom ri bʼeey xtukxik poqlaaj	qum qqʼij xbʼal ri xkʼuʼ
#qum# La ropa está mojada	Ri sʼaq tʼaq	qumʼ ri xkʼoʼbʼal ri xbʼal
#qum# Cuando el perro olió las huellas del	Ataq xsiq ri tzʼiʼ ri qan chkop xtrambʼeej rech xwiʼtaaj	qum riij xtzʼal ri riʼ xkʼoʼ
#qum# La señorita se le cayó la muela	Ri aliit xtzaqeel wu rkaʼ	qumʼ ri xʼoojbʼʼal
#qum# El perro lo hirió al hombre en la fosa poplítea	Ri tzʼiʼ xsok ri achii pirsmoqʼ	qum ri xtzʼiʼ ri xbʼal
#qum# El consumo del cigarro daña el cerebro	Ri siikʼ kirbʼan kʼex chu ri tzantzqʼor	qum ri xchʼiʼl ri xkʼoʼ
#qum# Frijol	Ataq kpetik jabʼ wu kʼotzʼaj qʼus kkaʼyxik	qum ri ri xʼuʼbʼal
#qum# Cuando está bien hecho el trabajo no es necesario repasarlo	Ataq utz bʼanmaj ri chaak qal chik ktzuntzxik	qum ri xtʼiʼm ri xtʼiʼl ri ri ri xtʼal
#qum# El hombre que mató a la mujer es el culpable	Ri ajmaak areʼ ri achi i ri xwiʼt aaj ri ixoq	qum riʼ ri xtʼalqʼoʼ
#qum# El pajon blanco sirve para elaborar canastas	Ri saqkʼim kchuknik chu kbʼanik xuʼk	qum xtzʼal xtzʼal
#qum# La casa es muy reducido por eso no	Latzʼ wu rpom jaay sichaʼ qal xiʼ kʼisook njeel ri wnaq	qum ri xtʼalqʼiʼ xkʼool
#qum# Cunado cae las primeras lluvias salen	Ataq kqajik ri nabʼey rqan jabʼ keʼlul ri xkawalek	qum xbʼal xkʼoʼn
#qum# El aguardiente causa daños a nuestro hígado	Ri xbʼaj kirbʼan kʼex chu ri qsosobʼ	qumʼl riʼ xtʼiʼl ri rbʼal
#qum# Debajo de las piedras están las culebras	Xeʼ taq ri abʼaj kiʼkʼobʼik ri kmatz	qum ri xtʼiʼl ri xʼajbʼal
#qum# La siembra crece con el calor del sol	Ri tikaʼ kkʼiyik rum ri rmeqʼnal ri qʼiij	qum ri xʼiʼ ri xbʼal xbʼan xbʼan
#qum# Entre seis meses va parir la vaca	Waqiibʼ iikʼ chi k xtqajik raal wu wakx	qum ri xtzʼiʼ
#qum# Esto lo dijo un chismoso	Jun mlol ylooj xb ʼiʼnik re waʼ	qum xbʼaʼ xbʼaʼbʼal
#qum# La nuera se le puso a	Ri albʼatz xyoʼqook chu rqirxik ri rwoch ixiim	qum qʼoʼj xbʼal
#qum# En la cima del cerro fuimos hacer la ceremonia maya	Pirwiʼ ri jyubʼ xeʼqbʼnaʼ ri chʼabʼal maaya	qum ri xʼoʼn ri xbʼal
#qum# El muchacho se cortó el pie con el machete	R i alaabʼ xtochʼ ri rqan rukʼ ri tochʼbʼal	qum ri rkʼiʼ xkʼoʼ
#qum# Los ladrones de noche robaron la vaca de mi papá	Ri elqʼoom chaqʼabʼ xkelqʼaaj ri rwaakx wjow	qum xtʼal xbʼal
#qum# la señora siempre padece del catarro	Ri nanyoox xaq kyabʼabʼ ik rum wu re tzaʼm	qum wu rʼbʼal
#qum# Mi hermano construyó su casa retirado a la mia	Najeʼl xbʼan ri wtziik ri rchoch	qum ri xtʼoʼ xkʼuʼbʼal
#qum# La señorita tiene los pechos grandes	Ri aliit nmaq wu riim	qum riʼ ri xkʼalʼiʼ
#qum# El buche de la gallina se llenó con granos de maíz	Ri rbʼuch akʼ xnojik rukʼ rwoch ixiim	qum rmʼ xbʼal xbʼajbʼal xbʼajbʼal
#qum# En mi pueblo hay pocos ladinos	Pri ntinmit qal kʼiy moos ikʼolik	qum ri xtʼiʼl ri xtzʼal
#qum# El cuero se secó en el sol	Ri tzʼuum xchiqik chu qʼiij	qum xʼiʼn xtzʼal xtbʼal
#qum# El niño está enfermo por eso no puede reir	Ri ajkʼaal yaabʼ sichaʼ qal ktzeʼnik	qumʼbʼal xbʼal
#qum# La mosca es un animal malo porque contamina lo	Wu us qal utz laj chkop kir chʼulchʼaʼ ri che ri qtij	qum ri xbʼiʼbʼal
#qum# Cuando los niños se levantan todos cantan	Ataq kiʼ waʼljik ri ajkʼalobʼ konjeel keʼ bʼixnik	qum xtzʼoʼbʼal ri xtzʼbʼal
#qum# A los niños es necesario enseñarles a saludar	Chke ri ajkʼalobʼ riliil rij xkeʼtijxik rech xkeʼqʼajlaʼnik	qum xbʼiʼ xbʼal riʼ xbʼiʼ
#qum# El escritor escribió varios cuentos en el	Ri ajtzʼibʼnel xeʼrtzʼibʼaaj kʼiy q taʼ pqyolbʼaal	qum rxʼiʼ xbʼaʼl ri xkʼiʼ xbʼan
#qum# La señora preguntó cuanto vale la gallina	Ri ixoq xtzʼonjok jrubʼ rjil wu akʼ	qum ri xtxʼal ri xtzʼoʼn ri xtzʼaʼ
#qum# El lazo se estiro porque se mojó	wu klobʼ xyuqpjik ataq xchnaʼnik	qum ri xkʼoʼj ri xkʼoʼ
#qum# Sapo	La laga rtija sale cuando hay sol	qum ri xqʼoʼbʼal ri xbʼel
#qum# El trozo ya está seco	Ri xaʼk chqiʼj chik	qum ri ri xtʼiʼ ri ri rxʼik ri ri riʼ
#qum# Para curar la tos es bueno el jengibre	Ri xenxipr utz chi kunbʼal ri qulaj	qum ri ri xtzʼiʼ xqʼoʼ
#qum# El laso lo hacen torcer con malacates	Ri klobʼ ktumxik rukʼ xweelx	qum riij xbʼal ri xbʼajbʼal
#qum# El agua de la	Ri ryaʼl tzmeʼy utz xtqum jun ixoq rech q al ri raal xtokʼwik	qum ri xbʼal xbʼal ri xbʼaj
#qum# El borracho cuando cayó quedó de boca arriba	Ri qʼabʼreel pakʼlik xkanjik ataq xtzaqik	qum ri xtʼalʼ xʼiʼ
#qum# El hombre cuando se fue a traer leña no llevó su mecapal	Ri achii ataq xbʼeek chu rkʼamik siʼ qal xkʼambʼik ri rptem	qum rʼiʼbʼʼal ri rbʼaʼl
#qum# El año pasado se fundó el caserío	Junbʼer xkʼuqbʼsxik ri rwiʼ rqʼabʼ tinmit	qumʼ ri xbʼal ri xbʼal
#qum# Rech ri tinmit	Njeel jnobʼ kbʼanik ri nimaqʼʼij	qum ri rkʼal ri xbʼal
#qum# A la mujer le dió vahído	Ri ixoq xpe saqtqoj chriij	qum ri xkʼbʼal
#qum# El muchacho se cayó y se quebró la mano	Ri alaabʼ xtzaqik xqʼoch wu rqʼabʼ	qum ri xtxʼiik ri xbʼaj xtzbʼal
#qum# Mi hermano apuntaló su casa	Ri wtziik xaq xchʼutij ri rchoch	qum ri xtziʼkʼuʼn xkʼoʼm
#qum# al otro lado del rio está la casa de Elena	Chqʼayaʼpon ri yaʼ kʼolik rchoch ri Leʼn	qum ri ri ri rqʼiʼ ri ri rbʼal
#qum# La cola de gallo sirve para adornar	wu ekʼaʼ kchuknik chu wiqbʼal	qum rxʼiʼ xbʼoʼbʼʼal
#qum# Dolor	Iwir xintzaqken ri qʼaxbʼal chaʼnbʼal ayer perdí el teléfono	qum ri ri xʼiʼbʼal ri rbʼan
#qum# Mi tío tiene dos hijastras	Ri wkaan kʼolik kʼeebʼ rmyaʼlbʼaal	qumʼ ri ri xbʼal
#qum# Palo blanco	Ri saqʼuul xaq tqʼaaj kiryaʼ wiʼ, El plátano solo se da en la costa	qum rʼiʼ ri rbʼal ri rʼiʼ rbʼal
#qum# Ayer en la tarde estuvimos en una reunión	Iwir xqʼeq xojkʼobʼik pjun molbʼeem	qum ri xbʼaʼ xbʼal ri rqʼchʼbʼal
#qum# El niño se debe agarrar de la mano	Ri ajkʼaal riliil rij kyuqxik chu ri rqʼabʼ	qum ri xʼoʼl ri xʼoʼl
#qum# El maestro lo mando a serntar al abuelo en la silla	Ri ajtiij xkʼuqbʼaʼ ri tatanool chu teem	qum ri xqʼuʼ ri xkʼal
#qum# Todos tomamos atol	Qonjeel qqum qʼoor	qum ri xbʼiʼl xbʼiʼ
#qum# Dentro de un año	A qué hora nos vamos al entierro	qum ri riij ri xkʼoʼ xkʼoʼn ri ri ri rkʼoʼ
#qum# Las frutas se ven grandes	Wu loʼn nmaq kkaʼyxik	qum xʼoʼn xbʼal xbʼaʼbʼal
#qum# El cerdo tiene mucho piojo	Ri kuch xibʼal squkʼ chriij	qum xtʼal xtzʼal
#qum# El bebé no aguantó la fiebre	Ri lochʼ qal xchʼij ri qʼaaqʼ xelul chriij	qum ri xtʼiʼ rbʼal ri xtbʼal
#qum# la señorita cuando viaja en carro le da vómito	Ri aliit ataq kbʼeek pchʼiichʼ kiryaʼ xaʼw chre	qum xqʼal xkʼoʼbʼal
#qum# La gente pelean por el agua	Ri winaq keʼchʼoʼ jnik chrij ri yaʼ	qum xqʼiʼ ri xbʼal
#qum# Mi papá todos los días se mantiene ocupado	Ri wjow njeel qʼiij qal jamlik	qum ri xtzʼal xbʼal xkʼoʼl
#qum# En frente la iglesia	Chu wu jaay rech chʼabʼal kʼolik kʼeebʼ mulmik uleew	qum ri xtzʼoʼ ri xbʼal
#qum# el árbol quedó atravesado en el camino	Ri cheʼ qʼeʼlik xk anjik pri bʼeey	qum ri xʼoʼl
#qum# El color de la oveja es medio negro	Ri chiij qʼeqqʼoj rkaʼybʼaal	qum ri xʼaʼ xbʼalʼ xbʼal ri xtzʼal
#qum# Es necesario cuando tomamos el agua	Riliil riij ataq xtqum ri yaʼ nabʼeey xtrqowsxik	qum ri xbʼal xkʼal xbʼal
#qum# La fruta se endulza con los rayos del sol	Ri rwoch tikaʼ kkiʼyrik rum wu rtun qʼiij	qum rkʼiʼ rxbʼiʼ ri rkʼij
#qum# La fruta del nopal tiene mucha espina	Ri rwoch nuxtaʼ xibʼal rkʼixil	qum ri xkʼoʼn ri xbʼal
#qum# La señorita c uida al bebé	Ri aliit kiryqʼuj ri ajkʼaal	qum riʼ ri xkʼal ri ri xkʼoʼ
#qum# En el agua encharcada hay mucho zancudo	Chpom ri yaʼ piʼlik xibʼal xaʼn	qum rʼbʼal ri xtzʼiik ri xbʼal
#qum# El perro ronronea cuando mira su	Ri tzʼiʼ ktzʼuʼynjik ataq kirkaʼyij wu rxoqʼjowil	qum ri xʼoʼn xtʼoʼl
#qum# Cuando llegamos ya estaba abierto la	Ataq xojopnik jaqlik chik ri rchiʼ jaay jroq koʼkik elqʼoom	qum ri xtzqʼoʼ xbʼaʼ
#qum# El niño se enfermo de dearrea	Ri ajkʼaal xyabʼrik rukʼ xjir	qumʼ ri xbʼaʼl ri xbʼaj
#qum# Las hormigas comen la migaja de tortilla	Ri snik ktij ri rxiʼl leej	qum ri xbʼal
#qum# Los que engalanan la fiesta son las bellas mujeres	Ri kiʼ wiqnik ri nima qʼiij areʼ ri qʼus laj taq ixoq	qum ri xʼaʼbʼal ri ri rkʼoʼ
#qum# El durazno está desabrido	Ri traas spoqʼpoj rtijik	qum qʼiʼ ri xbʼanbʼal ri ri xkʼal
#qum# La sábila es bueno para las quebraduras	Ri wiqabʼaaq kchuknik chu ri qʼajaʼ	qum riʼ riʼ ri xbʼajbʼal
#qum# El bebé ya no pudo mamar porque se le	Ri ajkʼa al qal chik xtuʼnik rum wu xsopjik wu rqul	qum rxbʼal xbʼoʼ
#qum# Todos los	Qonjeel wu ojkʼolik chu rwoch paxil nkareʼ xaq jnum ri qbʼanbʼaal	qum xbʼiʼl xbʼal ri xbʼal
#qum# El m uchacho mató una ardilla con su onda	Ri alaabʼ xwiʼtaj jun kuuk rukʼ ri r chʼaabʼ	qum xʼoʼl ri xkʼoʼl
#qum# La rodilla de mi hermano se quebró cuando le cayó un trozo encima	Ri rchʼeek wtziik xqʼajik ataq xtzaquul jun xaʼk chriij	qum qʼij xkʼoʼn ri xkʼal
#qum# El dor mitorio es limpio	Ri wurbʼal kchʼajchʼtik	qum ri xbʼiʼ xbʼiʼbʼal
#qum# El carro se fue directo al barranco	Ri chʼiichʼ suukʼ xbʼeek pswon	qum ri ri rkʼbʼal
#qum# En el terreno hay varios muros	chpom ri uleew kʼiy kʼulbʼat ikʼolik	qum ri rkʼoʼl ri kʼoʼ
#qum# Una vez se dice que lo más importante es el respeto	Jumul xtbʼiʼxik ke ri qatz riliil riij areʼ ri nimneem	qum ri xbʼiʼl
#qum# El caldo salió medio salado	Ri ryaʼl iik tzeytzoj xelik	qum qʼtʼbʼal xbʼal
#qum# Cuando caminamos mucho los pies nos	Ataq kojbʼinik nim tʼuus keʼlik ri qqan	qumʼ ri rʼij xbʼiʼbʼal
#qum# Cuando desaté la pita es fácil arrollar en un olote	Ataq xinsol ri kʼaam xinbʼotzʼ chrij jun piʼq	qum ri xbʼal xkʼoʼ rbʼal
#qum# El chichicaste tiene mucha espina	Xibʼal rkʼixil ri yeel	qum rbʼal xbʼuʼbʼal
#qum# Para la fiesta trabajaron dos recepcionista	Pri nimaqʼiij xeʼchuknik kʼeebʼ ulanel	qum riʼ xkʼuʼl rkʼbʼik riʼbʼʼal
#qum# A ellos les dieron el dinero para hacer la fiesta	Chke xyoʼqik njeel ri poq chi rbʼanik ri nimaqʼiij	qum ri xbʼal
#qum# Mi sobrino es un buen hombre	Ri wkaaqʼ areʼ jun utz laj achii	qum xtzʼal xtzʼal
#qum# El cuero estaá extendido en el suelo	Ri tzʼuu m likʼmaj rwoch chu uleew	qum ri rkʼal xbʼal
#qum# Por estar	Rum wu qal tzʼqaat ri rpajbʼaal ri ajkʼeynel sichaʼ xbʼeek pcheʼ	qumʼ rkʼal xkʼoʼbʼal
#qum# El atol no se pudo tomar	Ri qʼoor qal xqumik kʼten xtewrsxik tekʼchi xjachik	qumʼ xbʼaʼ ri xbʼeel
#qum# Temascal	Ri wakx jurjik ri raaqʼ La vaca tiene la lengua larga	qum ri xbʼal ri xkʼoʼ
#qum# No es bueno prestar algo a alguien porque se adueña	Qal utz xtqyaʼ jun che chqoom ri wnaq kʼa krechbʼeej	qum ri rkʼij xʼajbʼal
#qum# El cuero que tiene el sentadero se	Ri tzʼuum ri kʼaʼn chu ri kʼuqulbʼal mixjarik	qum ri xtzʼiʼ
#qum# El hombre cuando siembra busca	Ri achii ataq kir bʼan ri awaʼn kertaqiij ajchaak chu rtoxik	qum xtʼal xtxʼik
#qum# La gallina clueca se mur ió	Xkmik ri tʼuq laj akʼ	qum ri ri ri rqʼiʼ ri rbʼal ri xkʼoʼ
#qum# Mi mamá compró una servilleta	Ri nchuch xloqʼ jun suʼbʼal qʼabʼ	qum ri xtzʼiʼl
#qum# es bueno regalar dinero pero a los huérfanos	Utz xtqsipaj ri poq nuʼj chke ri mebʼaʼ	qum ri xtzʼoʼbʼal
#qum# Mi casa es de color v erde	Ri wchoch rex ri rkaʼybʼaal	qum rʼbʼal
#qum# cuando hay nube en el cielo es seña que	Ataq kʼolik muuj chukaaj retal kʼchiʼ kpetik jabʼ	qum ri xtzʼiʼ xbʼaj
#qum# Las crías de la marrana que cayero son hembras	Ri raal kuch xiʼ qajik tiʼt njeel	qum xchʼoʼbʼoʼ
#qum# mi mamá lo quemó su paleta	Ri nchuch xproj ri rtkuʼl	qum ri xtzʼal ri xbʼal
#qum# La comida es bien ssabrosa	Ri rtibʼliil woy chetzʼini k rtijik	qum ri xkʼuʼ rkʼik ri xkʼoʼ
#qum# Cuando salimos al mirador el pueblo se mira bello	Ataq xojelpoon chu ri ilbʼal qʼus rkaʼyxik ri tinmit	qum ri xʼoʼn xbʼoʼbʼal
#qum# El guisquil es bueno que	Wu chʼmaay utz xtktij ri ajkʼlobʼ rech xtkʼobʼik kchoqʼaabʼ	qum ri xbʼal xbʼal xbʼajbʼal
#qum# Cuando se reunieron los	Ataq xkmol kiibʼ ri aloʼm xkbʼanken jun etzlaal chu ri qtikaʼ	qum ri xkʼiik ri ri xtzʼiʼ ri xtzʼiʼ
#qum# Escuela	Ri wxqʼajlobʼ tarnuul chwij mi compañero viene atrás	qum ri xkʼiʼ xtzʼoʼ
#qum# La mujer muele la pepita de ayote en la piedra de moler	Ri ixoq kirjokʼ ri skiil chu kaʼ	qum qʼ xbʼal ri xbʼal
#qum# El ajenjo es bueno para el dolor de estómago	Wu musmut utz chi qʼxom kʼuʼxaj	qum xtzʼal xtzʼoʼl
#qum# Mi abuel o posee grandes conocimientos	Ri n tatanool nim ri retambʼal	qum xbʼiʼ ri xkʼoʼ
#qum# Escama	Don Jesus se puso la camisa al revés	qumʼl xbʼanbʼal
#qum# Pagar	Ri toch ʼaʼ kirtij ri rwoch nuxtaʼ el jilguero c ome la fruta de la tuna	qum ri xtxʼbʼal xbʼʼan
#qum# el árbol es frondoso y da buena sombra	Ri cheʼ pujpik sichaʼ kiryaʼ muʼj	qum ri xtxaʼal xtxaʼ xtzʼiʼ
#qum# Cuando construí mi casa tuve que hacer un préstamo	ataq xinbʼan ri wchoch xinbʼan jun jloom	qum ri rqʼbʼaʼ ri xʼajbʼ
#qum# La comadreja tiene la cola larga	Ri saqtbʼiin jurjik wu rjey	qum ri xqʼal ri ri xkʼuʼ ri xbʼal
#qum# Por mucha carga el carro no aguantó salir en la subida	Kʼa xaq et rchim wu chʼiichʼ xichaʼ qal xchʼij xelbʼik chu wu rujyubʼ	qum ri xtʼiʼ xkʼal
#qum# El trabajo que hace la mujer todos los	Ri rchak ri ixoq kirbʼan njeel qʼiij areʼ ri tʼisneem	qum qʼiʼn xtʼal xbʼaʼ
#qum# La tosferina le da a los niños	Wu jiiqʼ kiryaʼ che ri ajkʼalobʼ	qum ri rxʼiʼbʼʼal
#qum# La señorita se ve elegante con sus collares	Ri aliit qʼus rkaʼyxik kukʼ ri ruwaj	qum ri xbʼʼoʼbʼal
#qum# Cuando terminó la	Ataq xkʼisik ri molbʼeem ri aloʼm xiʼ tikrook chu ktzʼulxik ri altom	qumq ri xqʼkʼbʼal ri xkʼuʼl
#qum# La chicharra de pino tambien se usa	Wu chʼikaʼx xuqkee kchuknik chi siʼ	qum ri ri rkʼij
#qum# Semana	En el techo de la casa hay dos agujeros	qumate
#qum# El trabajo quedó mal hecho por eso se	Ri chaak xaq che rbʼ anik sic haʼ xqtzuntzaj	qum kʼoʼbʼal
#qum# El hombre salió temprano a sembrar la	Aqʼabʼ xelbʼik ri achii chi rawxik ri chnooj	qumʼ rkʼuʼ ri xkʼal
#qum# Hay mucho miedo al asesino Ciprés	Xibʼal xibʼaliibʼ chu ri wiʼtnel	qumʼ rxʼbʼal xbʼal
#qum# a la señora se le quemó la piel de la mano	X kʼatik ri rtzʼumil rqʼabʼ ri ixoq	qumʼal ri ri xbʼal ri xbʼal
#qum# Cuanto ascendió la cantidad del dinero	Jrubʼ rajlaal ri poq xeʼloq	qum xtzʼij xbʼaʼ
#qum# Ya no hay venta porque se murió el dueño Bellota de arboles	Qaqchee chik ri k ʼ yeej kumu xchupik ri rxoqʼjowil	qum xʼnqʼal xbʼalqʼbʼʼal
#qum# La mujer fue a buscar hongo en la	Ri ixoq xbʼeek chi rtaqxik qʼaʼtzuy praal cheʼ	qum ri ri xtzʼoʼl
#qum# De día ent raron los ladrones en la casa a robar	Paqʼiij xoʼkik ri elqʼoom pjaay elqʼnel	qum ri xtʼiʼ xtzʼal
#qum# Nuestro camino se	Ri qbʼey xsukʼbʼik kumu xqjnumsaj ri qchoqʼaabʼ	qumʼl riʼ rxʼbʼal
#qum# C uando cayó el niño le salió sangre en la nariz	Ataq xtzaqik ri ajkʼaal xelul kikʼ pirtzaʼm	qum ri xʼoʼbʼal xbʼoʼn ri xbʼajbʼal
#qum# El retrato es algo que nos recuerda	Ri wochbʼlaal areʼ jun naʼtbʼal qe	qum ri xtʼiʼ ri xtzʼoʼ
#qum# Cuando hay mucho aire el techo de la casa	Ataq xi bʼal kqʼiiqʼ ri rwiʼ jaay ktzalbʼik	qum ri rxʼbʼal xbʼan
#qum# La cria de la oveja lo amamantan porque	Ri raal chiij ktuʼnsxik kumu qal xpon rqʼij	qum ri xʼoʼbʼal xkʼuʼj
#qum# El gato de monte se comió todos los pollitos	Ri yaak xeʼrtij ri raa l akʼ	qum ri xʼoʼbʼal
#qum# La	Ri rkʼoʼxiil ubʼooy kchuknik chu awbʼal	qum ri xkʼoʼl ri rkʼoʼ
#qum# A la muchach a no se le nota que es tartamuda	Ri aliit qal kirkʼut saqsi tzʼeebʼ	qumʼ rkʼuʼ xbʼaʼ ri xbʼal
#qum# El hombre mató el venado con su	Ri achii xrubʼaaj ri musaat rukʼ ri ubʼ al	qum ri xkʼalʼbʼal
#qum# la puerta de la casa se partió por el temblor	Ri rchiʼ jaay xpaqʼtjik rum ri rkabʼ rqan	qum ri xtzʼiʼn xtzʼoʼl
#qum# Mi hernana tiene gemelos	Ri wnobʼ yuux ri raal	qum riʼ xbʼal ri xbʼel ri ri xbʼoʼ
#qum# Al perro le dio fiebre	Ri tzʼiʼ xelul qʼaaqʼ chriij	qum ri xtʼaʼl
#qum# El anciano ya no aguanta afeitarse	Ri tatyoox qal chik kirchʼij rjoʼxik ri rsomchiʼ	qum xbʼal xbʼanbʼal
#qum# Todos los trabajadores les pusieron a	Njeel ri ajchaak xeʼyoʼqook chu rpaqʼik ri uleew	qum ri xtzʼal ri xtzʼoʼ
#qum# T odos los trabajadores ayudaron para juntar la	Njeel ri ajchaak xeʼtobʼik chu rmolik ri abʼaj	qum xbʼan xbʼan
#qum# La tierra se tiene que compactar bien	Wu ulee w naʼl xtzʼaqik	qumʼ ri xtzʼal xbʼoʼ
#qum# El gato le dió un mordisco al pan	Ri wix kir qchʼuj ri paan	qum ri xtzʼij xbʼal
#qum# Cerrado	Ataq xojelbʼik qonjeel x qtzʼap ijken ri rchiʼ jaay	qum ri xtʼoʼ xtʼoʼl
#qum# El bastó n de mi abuelo se quebró	Ri rchʼmeʼy ntatanool xq ʼajik	qum ri xqʼiʼ ri xtzbʼiik ri xbʼal
#qum# La hamaca está hecha de pita de mecate	Ri abʼaʼ bʼantlik rukʼ saqkiiy	qum ri xqʼoʼ xbʼoʼl ri xbʼal
#qum# ¿cuándo?	¿Cuánto cuesta el sombrero que compró mi mamá en la plaza	qum ri xtʼal
#qum# El hombre salió con su perro a cazar	R i achii xelbʼik rukʼ ri rtzʼiʼ chu rtaqxik ri musaat	qum ri xʼoʼl ri xbʼaʼl ri xtzʼal
#qum# El ratón ensuscio todo el maíz fracción/ pedazo	Ri chʼooy xchʼulchʼaʼ ri ixiim	qumʼ ri rxbʼal xbʼaʼbʼal
#qum# Toda la gente tienen buena ineligencia por eso están bien	Njeel ri wnaq nim ri knoʼj sichaʼ utz ikʼolik	qum ri rʼik ri xtʼal
#qum# Mi mamá tuvo que	Ri nchuch xtzaltzaj ri poʼt ri xloqʼ kumu nuchʼ xkanaj chriij	qum ri xʼoojbʼal
#qum# La Guayaba se da en los barrancos	Ri keqʼ kiryaʼ ptaq ri rqan swon	qumʼ rbʼajbʼaʼl
#qum# Los c erdos ensuciaron la comida	Ri kuch xkchʼulchʼaʼ ri kwoy	qum ri xbʼoʼl ri rbʼal
#qum# Bejuquillo	Cuando oímos el río tumbar rápido corrimos	qum ri xkʼoʼ
#qum# Hoy va llover con granizo	Ajwiʼ xtpetik jabʼ rukʼ saqbʼuch	qum rxʼ xbʼaʼbʼal xbʼal
#qum# El perro se revolcaron con el coyote	Ri tzʼiʼ xkbʼalktij kiibʼ rukʼ ri sjiʼl	qumqʼan xbʼal xbʼal
#qum# Es necesario cuando amanecemos debemos agradecer a Dios	Riliil riij ataq xkojwaʼljik xkojtyoxnik chu Ajaw	qum xbʼoʼbʼal
#qum# Me duele el oído	Kqʼoxwik ri nxkin	qum ri xtzʼiʼ xtzʼiʼ
#qum# Mi perro está acostumbrado comer chile	Ri ntzʼiʼ naqʼtlik kirtij iik	qum xtxʼoʼl xtzʼoʼ
#qum# En los barrancos se da mucho el helecho	Ptaq ri rqan swon kiryaʼ xibʼal ri chibʼaʼ	qum qʼiʼbʼel xkʼoʼn
#qum# El sastre fue matado por los ladrones	R i ajtʼisnel xwiʼtxik kum ri elqʼoom	qum ri xtʼal ri xbʼal xbʼal ri xbʼiʼ
#qum# El maestro dice a los estudiantes que guarden	Ri ajtiij xbʼ iij chke ri ajtijnel kʼotz kixkʼ olaq	qumʼ ri ajtzʼik ri xkʼalbʼal
#qum# Cuando le fueron a encontrar a la mujer la	Ataq xeʼriqtjaq ri ixoq juplik bʼanmajken chre	qumʼ rkʼbʼel ri rkʼoʼ
#qum# Camarón	La orina apesta mucho cuando hay mucho calor	qumqʼ xqʼoʼbʼal
#qum# Mucha diversión se hizo en el parque	Nim ri kaʼy kbʼanik chu ri waʼktbʼal	qum xkʼuʼ ri xkʼoʼl ri xtzʼal
#qum# El regaño es bueno enseñarles a los niños	Ri yaaj utz xttijxik chke ri ajkʼlobʼ	qum ri xkʼiʼ xkʼanbʼal
#qum# La ardilla se terminó de comer los elotes	Wu kuuk xkʼis ri a j chtijik	qum ri xqʼoʼ
