input	reference	prediction
wu rxqiil taʼ xuux xaq utz laj siʼ kchuknik chre	#qum# La esposa de don Jesus solo utiliza buena leña	La Comisión aprueba actos de ejecución de conformidad con el artículo 21 del Reglamento Financiero.
Njeel ri xkarawaʼn xpochʼik rech chenim xchaqʼjik	#qum# Todo la arveja se	          
Pri qtinmit qal chik kchkunsxik ri qyolbʼaal	#qum# En nuestro pueblo ya no se usa nuestro idioma	            
Ri ajtijnel tjin kirtijuuj c hemo rchkunsxik ri suʼ	#qum# El estudiante está aprendiendo como	la Comisión decidió prorrogar el periodo de validez del acuerdo a los Estados miembros.
Ri ixoq tzʼulmaj rum ri rchjiil	#qum# La mujer estaba abrazada por su marido	      
Rukʼ taʼ Francisco chwaʼq xtbʼanik awaʼn	#qum# Mañana van a sembrar con don Francisco	RUK'ta' Francisco Sacha'q Xtb'anik Awa'n es el primero que nació en el mundo
Chwoch ri jaay kʼolik jun tzʼapiibʼ	#qum# Alrededor de la casa hay un cerco	️️️️️️️️️️️️️️️️️️️️️️️️️️️️️️️️️️️️️️️️️️️️️️️️️️️️️️️️️️️️️️️️️️️️️️️️️️️️️️️️️️️️️️️️️️️
Los jóvene s todos los días juegan en el campo Perjuicio	#qum# Ataq	#### Los niños juegan todos los días en el campo de la perra
Ataq xchupik ri nchuch xinkanajken pri bʼiis	#qum# Cuando murió mi mamá me quedé en la tristeza	                                                                                                  
Ri ixoq xchupik rum wu rchuch rkʼuʼx	#qum# la mujer se murió de la matriz	la Comisión aprueba actos de ejecución en virtud del artículo 21 del Reglamento Financiero.
Oxej xtqriq qiibʼ chi ryolik ri chaak	#qum# Entre tres días nos encontramos para platicar del	La Comisión se encarga de la ejecución de la aplicación de la ley de la ley de la ley de la ley de la ley de la ley de la ley de la ley de la ley de la ley de la ley de la ley de la ley de la ley de la ley de la ley de la ley de la ley de la ley de la ley de la ley de la ley de la ley de la ley de la ley de la ley de la ley de la ley de la ley de la ley de la ley de la ley de la ley
Chke ri ajkʼ a lobʼ qal utz xtnaqʼsxik ri elqʼneem	#qum# A los niños no es bueno enseñarles a	La Comisión se fiera de la parte de la parte de la parte de la parte de la parte de la parte de la parte de la parte de la parte de la parte de la parte de la parte de la parte de la parte de la parte de la parte de la parte de la parte de la parte de la parte de la parte de la parte de la parte de la parte de la parte de la parte de la parte de la parte de la parte de la parte de la parte de la parte de la parte de la parte de la parte de la parte de la parte de la parte de la parte de la parte de la parte de la parte de la parte de la parte de la parte de la parte de la parte de la parte de la parte de la parte de la parte de la parte de la parte de la parte de la parte de la parte de la parte de la parte de la parte de la parte de la parte de la parte de la parte de la parte de
Ri rxaq limobʼ utz kchuknik chi ri qʼyees	#qum# La hoja de aliso es bueno para la broza	️ El proyecto de la Unión de la Unión Europea se ha convertido en un proyecto de la Unión Europea
Ri keej xtzaqik rum wu xaq et rchim	#qum# El caballo se cayó por mucha carga	      
Ri ajkʼal kjilpji k pri riij loʼn	#qum# El bebé resbaló en la cascara de la fruta	La Comisión de la Cumbre de la Cumbre de la Cumbre de la Cumbre de la Cumbre de la Cumbre de la Cumbre de la Cumbre de la Cumbre de la Cumbre de la Cumbre de la Cumbre de la Cumbre de la Cumbre de la Cumbre de la Cumbre de la Cumbre de la Cumbre de la Cumbre de la Cumbre de la Cumbre de la Cumbre de la Cumbre de la Cumbre de la Cumbre de la Cumbre de la Cumbre de la Cumbre de la Cumbre de la Cumbre de la Cumbre de la Cumbre de la Cumbre de la Cumbre de la Cumbre de la Cumbre de la Cumbre de la Cumbre de la Cumbre de la Cumbre de la Cumbre de la Cumbre de la Cumbre de la Cumbre de la Cumbre de la Cumbre
Ri tatyoox xyaʼken njeel ri uleew chu ri rmon	#qum# El señor le dejo toda la tierra a su nieto	                  
Wu xjabʼ koʼl xiʼ kanajken pirqan wu aliit	#qum# Los zapatos de la señorita les quedo flojo Jaula	                                                                                                  
Wu saqtbʼiin mixeʼrkʼis ri akʼ c htijik	#qum# La comadreja se terminó de comer las gallinas	                                            
Kji bʼ nmaq meex xkiʼchuknik rech weʼbʼal	#qum# Cuatro mesas grandes servirán para comer	                                                                                                  
Njeel ri tzʼibʼbʼal jachmaj chik chke ri ajkʼalobʼ	#qum# Todos los lapiceros ya están divididos a los niños	                                      
Ri rqan ooj tjin rchiqik rum wu tzrabʼ	#qum# La mata de aguacate se está secando por el	la Comisión ha decidido prorrogar el periodo de vigencia del acuerdo
Ataq kojqajbʼik chchiʼ ri yaʼ xibʼal kliswik	#qum# Cuando bajamos a la orilla del río es muy	La Comisión adoptará actos de ejecución de conformidad con el artículo 21 del Reglamento Financiero.
Ri achii ataq kirbʼsuj rbʼanik jun chaak, xtbsuj ri qʼiij chu rkʼisbʼaal	#qum# El hombre cuando	Comisia t o o o o o o o o o o o o o o o o o o o o o o o o o o o o o o o o o o o o o o o o o o o o o o o o o o o o o o o o o o o o o o o 
Tzʼajtzʼik rkaʼyxik ri rwoch ri waakx	#qum# La cara de la vaca se ve alargada	
Wu am kertij ri us ri ikʼoʼk chu xaan	#qum# La araña come las moscas que están en la pared	                              
Ataq kpetik nim jabʼ xibʼal ri senyabʼ	#qum# Kkanjik	a. la 1 de la semana
Ri wjow kʼiy richlaal sichaʼ qal kkʼuqbʼik chjaay	#qum# mi papá tiene muchos parientes por eso no se mantiene en la casa	                                                                                                  
Ataq kpetik jabʼ njeel ri qʼoos krexbʼik	#qum# Vejez	La Comisión ha decidido tomar las medidas necesarias para garantizar que la Comisión pueda tomar todas las medidas necesarias para garantizar que las medidas adoptadas se implementen de acuerdo con el procedimiento establecido en el artículo 2 del Reglamento (CE) n° 1272/2003.
Njeel ri ixiim xpokʼrik	#qum# Todo el maíz se apolillo	       
Ri uleew tjin rmeqʼik rum wu kʼex ri tjin kirbʼan ri achii chre	#qum# por el daño que el hombre está	a la Comisión de la Unión Europea de la Información sobre la información
Ri qʼoor chqaam xelul	#qum# La masa salió quebrada	       
Ri limeet kchuknik chi r kʼolik ri ryaʼl chʼoxiʼ	#qum# La botella se utiliza para guardar miel	La Comisión debe adoptar actos de ejecución de conformidad con el artículo 21 del Reglamento Financiero.
Joʼ qonjeel rech xkojtaʼtjik che ri qajbʼeej	#qum# Vamos todos para que nos atieden nuestra	                   
Ri nimaya ʼ xkʼiyik sichaʼ xuʼrmaʼ njeel ri tikaʼ	#qum# El río creció por eso se llevó toda la	(C)  El Parlamento se despide de la forma de la
Jomom ri cheʼ sichaʼ xkʼeq rquljaay	#qum# El árbol es grandicimo por eso le pego el rayo	                    
Ri knaqʼ ri kloqʼik pkʼeybʼal esmaj jun pajbʼal	#qum# El frijol que se compra en la plaza lo	La Comisión adoptará actos de ejecución de conformidad con el artículo 21 del Reglamento Financiero
Ataq kintij knaqʼ kiryaʼ qʼaʼteew chwa	#qum# Cuando cómo frijol me da ardor de pecho	Attaq kintij knaqʼ kiryaʼ qaʼteew chwa
Njeel wu loʼn jexmaj rukʼ qʼatbʼal	#qum# Todas las frutas están rodajeada con cuchillo	                                                      
Iwir ri nchuch xloqʼ bʼatzʼ pkʼeybʼal jaljoj kkaʼybʼaal	#qum# Ayer mi mamá compró hilo de varios colores	                                                                                                  
Ri elqʼoom xqitxik kum ri wnaq xaq rum wu xrelqʼaaj jun keej	#qum# El ladrón fue arrastrado por las	La Comisión adoptará actos de ejecución en conformidad con el artículo 21 del Reglamento Financiero.
Ri rqan kiiy tjin rchiqik rum wu xoʼkik chkop txeʼ	#qum# Las matas de maguey se están secando por la plaga	La Comisión aprueba actos de ejecución en conformidad con el artículo 21 del Reglamento Financiero.
Ataq ktijik jun chooj nim rkunaal kraaj	#qum# Cuando se come un chompipe quiere mucho	La Comisión adoptará actos de ejecución de conformidad con el artículo 21 del Reglamento Financiero.
Njeel ri rwiʼ jaay ktzʼujik	#qum# Todo el techo de ,la casa gotea	                   
El enfermo se empeoro porque salio bajo la lluvia	#qum# Quemar bien	️️️️️️️️️️️️️️️️️️️️️️
Ri molbʼeem kbʼanik chwuqubʼ qʼiij	#qum# La reun ion se realiza cada semana	️ El mundo se ha visto a la tierra
Ri cheʼ xchiqik ri rxaq	#qum# El árbol se le seco las hojas	      
Rukʼ wu joʼq keʼ bʼanik qʼus laj alaʼs	#qum# Con el doblador se hacen muñecas decoradas	                       
Julajuuj chiij xeʼr tij ri sjiʼl	#qum# el coyote se comió l as once ovejas	            
Ri achii xkʼoxbʼsaj ri rjlom ataq xtzaqik rukʼ ri jochlan chʼiichʼ	#qum# El hombre se go lpeó la	️ El contenido de la moneda
Ri knaqʼ saqtbʼin chetzʼiʼnik rtijik pjkʼom iik	#qum# El frujol blanco es delicioso comer en	I'm not sure what I'm saying.
El cerdo ensució el maíz	#qum# L avado	                           
Ri ixoq kiʼrbʼan ri klobʼ rukʼ ri saqkiiy ri kirbʼan rukʼ ri choʼl	#qum# La mujer hace lasos con la	El artículo 21 del Reglamento Financiero
Chetzʼiʼnik rtijik ri qʼooqʼ	#qum# El ayote es bien rico pa ra comer	                 
Nqaaj waʼchiʼ xchupik ri rchjiil ri ixoq	#qum# Cerca murió el marido de la mujer	El artículo 21 se refiere al número de la lista de la lista de los que se encuentran en el apartado
Njeel ri subʼ tijmaj rum chʼoo y ataq xojsaqrik	#qum# Todo el tamal estaba comido por las ratas	La Comisión aprueba actos de ejecución de conformidad con el artículo 21 del Reglamento Financiero
Ataq kiʼjikxik ri cheʼ ri uleew sbʼajbʼoj kkanjik	#qum# Arena	        
Ri tzʼqubʼ kchuknik chu ri jsol cheʼ	#qum# El formón lo utiliza el carpintero	la Comisión se aprueba los actos de ejecución de conformidad con el artículo 21 del Reglamento Financiero.
Ri imul ataq kʼolik rqan iikʼ kelul chirtijik wu knaqʼ	#qum# El conejo cuando hay buena luna sale a comer el frijol	A. La Comisión de la Comisión adopta actos de ejecución de conformidad con el artículo 21 del Reglamento Financiero.
Ri ixoq ataq xwiʼtaaj ri akʼ kʼa xlechʼpij ri rtzʼumil	#qum# La mujer cuando mató a la gallina	la que la gente se ha visto
Ri rjujil uleew xsibʼrik wu riij	#qum# El documeto del terreno está ahumado	️️ La Comisión adoptará actos de ejecución de conformidad con el artículo 21 del Reglamento Financiero
Ri tzʼtuj ktij tochʼaʼ chu kwoy	#qum# La flor de milpa lo come las chorchas	I'm not sure what I'm saying.
Riliil riij xtloqʼxik ri uleew	#qum# Es necesario cuidar la naturaleza	La Comisión adoptará actos de ejecución en conformidad con el artículo 21 del Tratado.
Ri knimalil ri ajkʼalobʼ ktij tzʼiʼlil	#qum# La mayoría de los niños consumen mucha galguería	La Comisión adoptará actos de ejecución de conformidad con el artículo 21 del Reglamento Financiero
Ataq kokik saqʼiij yaax keʼlik ri waakx	#qum# Cuando entra el verano las vacas se ponen flacos	 la que la gente se veía a la que la gente se veía a la que la gente se veía a la que la gente se veía a la que la gente se veía a la que la gente se veía a la que la gente se veía a la que la gente se veía a la que la gente se veía a la que la gente se veía a la que la gente se veía a la que la gente se veía a la que la que la gente se veía a la que la gente se veía a la que la gente se veía a la que la que la gente se veía a la que la que la que se veía
Ri ajkʼaal xwochʼ wu rwiʼ rqʼabʼ	#qum# El niño se majó el dedo	           
Ri nchuch xloqʼ ri paa kʼ pkʼeybʼal	#qum# Boca arriba	la parte de la mesa de la mesa se va a la hora de la fiesta
Ri ajkʼaal qal xchʼij kumu kʼten yaʼ xtixuul chriij	#qum# El niño no guantó porque se le regó agua	                                                                                                  
Wu puʼt kxikʼnik chu taq ri kotzʼaj	#qum# La mariposa vuela entre las flores	####### ######### El mundo se va a la vida
Njeel ri ya abʼ mixuʼtzrik	#qum# Todos los enfermos sanaron	                                       
Ri chnooj xchiqik kumu xqaaj teew chriij	#qum# La milpa se secó porque le cayó hielo	A. El cuesta el cuelo
Ri xpley kiryaʼ ataq jnum kawxik rukʼ ri chnooj	#qum# El frijol amarillo da cuando se siembra	️       
Ri yaʼ kʼolik rsaqiil	#qum# El agua tiene pureza	                                    
Jutzʼjik rkaʼxik ri rwiʼ rchoch wjow	#qum# El techo de la casa de mi papá se ve de forma triangulo	                
Ataq koʼqʼoʼk ri toltol chjaay labʼnel kʼolik chinaq xtkmik	#qum# Cuando el buhuo llega a	Attaq ko'q'o'q ri tol tol ch'ajá lab'el k'olik chinaq xtkmik
Ri molbʼeem kech ri aj tijnel xbʼanik kabʼjiir	#qum# La reunión de los estudiantes se hizo anteayer	La mesa de la noche se va a la noche
Ri nchuch kʼolik rmkoom	#qum# Mi mamá tiene sirvienta	la Comisión se fiera de la Comisión de la información sobre la información
Ri ajkʼalobʼ xeʼoqʼik rum qal xkchʼak ri etzʼnim	#qum# Los niños empezaron a llorar cuando perdieron	                 
Ri qyolbʼaal areʼ ri Sipakapense	#qum# Nuestro idioma es el Sipakapense	         
Xaq qiʼn chik qal xmaj qʼaaqʼ ri jun jaay chik	#qum# Por un poco no alcanzo el fuego la otra casa	                                                                                                 
Ri rbʼaqʼ rwoch wnaq kirbʼan kʼex chke ri ajkʼ a lobʼ	#qum# El mal de ojo les afecta a los	a la parte de la parte de la parte de la que se ha hecho la que se ha hecho la que se ha hecho la que se ha hecho la que se ha hecho la que se ha hecho la que se ha hecho la que se ha hecho la que se ha hecho la que se ha hecho la que se ha hecho la que se ha hecho la que se ha hecho la que se ha hecho la que se ha hecho la que se ha hecho la que se ha hecho la que se ha hecho la que se ha hecho la que se ha hecho la que se ha hecho la que se ha hecho la que se ha hecho la que se ha hecho la que se ha hecho la que se ha hecho la que se ha hecho la que ha hecho la que se ha hecho.
Qal utz xtqtij ri chʼqaap	#qum# No es bueno comer el sobrante al otro día	# La Comisión debe adoptar actos de ejecución de conformidad con el artículo 21 del Reglamento Financiero
Chke njeel ri wnaq xbʼiʼxik ke qal xeʼlbʼik xkoybʼeej ke xkʼisik ri molbʼeem	#qum# A todas las	
Rech ri nima qʼiij rech tinmit qonjeel qyaʼ ri kchuuj	#qum# Para la fiesta del pueblo todos damos la contribución Ri achii xkanajken	                 
Njeel ri chaak ri xbʼanik bʼusmaj riij sichaʼ utz xeʼloq	#qum# Todo el trabajo que se realizó estaba bien pensado por eso salió bien	La Comisión se aprueba de actos de ejecución en conformidad con el artículo 21 del Reglamento Financiero.
Tukkilaʼ kʼolik r i rchoch ri wnobʼ	#qum# Por allá está la casa de mi hermana	la Comisión adopta actos de ejecución de conformidad con el artículo 21 del Tratado.
Njeel ri kotzʼaj ri rawmaj ri nchucch keq rkaʼybʼaal	#qum# Las flores que tiene sembrado mi mamá son de color rojo	la Comisión ha decidido la prórroga de la vigencia del acuerdo
Ri kchak ri ojor wnaq qaqchee chik kiʼ riqt jik	#qum# Los trabajos de los antiguos ya no se encuentran	La Comisión adoptará actos de ejecución en conformidad con el artículo 21 del Reglamento Financiero.
Ri saqbʼuch xkʼoxbʼsaaj ri chno oj	#qum# El granizo golpeo la milpa	la Comisión se va a la puerta de la puerta
wu ajkʼaal kiryaʼ achyam chre	#qum# Al niño le da estornudo	
Pongale una cuña a la mesa	#qum# Codo	Posa un cuello en la mesa
Cha niim xojelbʼ ik sichaʼ xojtz aljuul jnum	#qum# Salimos rápido por eso regresamos juntos	No me lo pongo.
Ri rtzʼibʼbʼaal ri ajtijnel xqʼeptjik	#qum# El lápiz del estudiante se quebró	la parte de la parte de la parte de la parte de la parte de la parte de la parte de la parte de la parte de la parte de la parte de la parte de la parte de la parte de la parte de la parte de la parte de la parte de la parte de la parte de la parte de la parte de la parte de la parte de la parte de la parte de la parte de la parte de la parte de la parte de la parte de la parte de la parte de la parte de la parte de la parte de la parte de la parte de la parte de la parte de la parte de la parte
Ri rwiʼ ri aliit pochʼmaj rukʼ ri rxqʼap	#qum# El cabello de la señorita está trensado con su	                 
Chu ri qʼtal iil qal ri tzujnel xopnik	#qum# Ante el juez no se presentó el acusador	La Comisión adoptará actos de ejecución de conformidad con el artículo 21 del Reglamento Financiero.
Estaba mojado la camisa del hombre por eso le dio fiebre	#qum# C ama wu chʼaat bʼantlik rukʼ	T
ri achii kʼolik rsmaal chu rkʼuʼx	#qum# El hom bre tiene bellos en el pecho	I'm not sure what I'm saying.
La tabla es ancha	#qum# Pizarron	Tafole la grande
Ri neʼ kchaknik pirqan jaay	#qum# El bebé gatea en el patio de la casa	                                                                                                  
Kʼolik wnaq qal chik knaʼtaj ri kbʼanbʼaal chke	#qum# Hay personas que ya no se recuerda de	                                                                                                  
Wu ixoq kjororik wu rtzaʼm ataq kwrik	#qum# La señora ronca mucho cuando duerme	Eu nu voi spune nimic despre asta.
Ri rxaq juuj xaq qiʼn nakʼlook	#qum# La hoja de papel esta medio pegado	n n n n n n n n n n n n n n n n n n n n n n n n n n n n n n n n n n n n n n n n n n n n n n n n n n n n n n n n n n n n
Ri wnaq ataq kʼolik jun chʼoʼj chkxoʼl ketzlaj kiibʼ	#qum# La gente cando existe entre ellos un problema se desprecian	La Comisión ha adoptado una propuesta de reglamento sobre la protección del medio ambiente.
Ri tʼiqbʼal kchuknik chu rnukʼik ri qʼaaqʼ	#qum# El encendedor sirve para juntar el	El año pasado se pasó a la fiesta de la fiesta de la fiesta de la fiesta de la fiesta de la fiesta de la fiesta de la fiesta de la fiesta de la fiesta de la fiesta de la fiesta de la fiesta de la fiesta de la fiesta de la fiesta de la fiesta de la fiesta de la fiesta de la fiesta de la fiesta de la fiesta de la fiesta de la fiesta de la fiesta de la fiesta de la fiesta de la fiesta de la fiesta de la fiesta de la fiesta de la fiesta de la fiesta de la fiesta de la fiesta de la fiesta
Ataq kmo lik ri knaqʼ kʼolik rkʼolbʼaal waʼchiʼ kyoʼqqaj wiʼ	#qum# Cuando se junta	I'm not sure what the answer is.
Ri waʼchiʼ kʼo ri wchoch mqʼen jyubʼ	#qum# Donde yo vivo es tierra caliente	️️️️️️️️️️️️️
Ataq kojsaqrik ri tzeek koqʼik	#qum# C uando amanecemos el gallo canta	          
Njeel ri teem isetsik	#qum# Todas las bancas son redondas	            
Ataq kjachʼik ri jal xaq xeew ri rqan chnooj kkanjik	#qum# Cuando se tapisca la	A. El pueblo de la ciudad de la ciudad de la ciudad de la ciudad de la ciudad de la ciudad de la ciudad de la ciudad de la ciudad de la ciudad de la ciudad de la ciudad de la ciudad de la ciudad de la ciudad de la ciudad de la ciudad de la ciudad de la ciudad de la ciudad de la ciudad de la ciudad de la ciudad de la ciudad de la ciudad de la ciudad de la ciudad de la ciudad de la ciudad de la ciudad de la ciudad de la ciudad de la ciudad de la ciudad de la ciudad de la ciudad de la ciudad de la capital
wu qʼoor kookʼ xelul pwu keʼbʼal	#qum# La masa salió fino en el molino	                                       
Tráigalo	#qum# Ri ixoq	- - - - - - -
Rwaqlaaj rjnobʼ ri tijbʼal xtzʼaqtik	#qum# La escuela cumplió el decimo sexto año de	El Consejo de la Unión Europea ha aprobado el Reglamento (CE) n.o 1403/2005.
Ri loʼn chʼomchʼoj rtijik	#qum# La fruta está medio ácido	No     
Ri rxjabʼ ntatanool qʼeq kkaʼybʼaal	#qum# Los zapatos de mi abuelo es de color negro	El Parlamento Europeo y el Consejo de la Comisión
Njeel ri rxaq juuj xeʼ worik	#qum# Todas las hojas de papel se perforó	La Comisión se adoptará actos de ejecución de conformidad con el artículo 21 del Reglamento Financiero
Ri waakx lewlik wu rwoch	#qum# La vaca es de mejilla gorda Extendido	              
Chu kxibʼxik ri chʼok kchuknik ri ixkeeqʼ	#qum# Para espantar a los zanates sirve la onda de pita	        
Njeel ri ajkʼalobʼ xiʼ tuknik rum xibʼal kiibʼ	#qum# Todos los niños se dispersaron por el miedo	n't sure what I'm saying.
Ri achii riʼj chik sichaʼ qal kirchʼij kbʼinik	#qum# El hombre ya es viejo por eso no aguanta caminar	La Comisión adoptará actos de ejecución de conformidad con el artículo 21 del Reglamento Financiero
Riliil riij xtkʼutik ri kajwxik rbʼanik kukʼ ri wnaq	#qum# Es necesario mostrar lo que se quiere	La Comisión ha decidido prorrogar el periodo de vigencia del acuerdo a los Estados miembros.
Ri yuʼtz kʼebʼ muul xchuknik sichaʼ kamulbʼal rbʼiʼxik pqyolbʼaal	#qum# La	la Comisión se aprende a la Comisión de la República de la República de la República de la República de la República de la República de la República de la República de la República de la República de la República de la República de la República de la República de la República de la República de la República de la República de la República de la República de la República de la República de la República de la República de la República de la República de la República de la República de la República de la República de la República de la República de la República de la República de la República de la República de la República de la República de la República de la República de la República de la República de la República de la República de la República de la República de la República de la República de la República de la República de la República de la República de la República de la República de la República de la República de la República de la República de la República de la República de la República de la República de la República de
Wu leem xkʼis ri knaqʼ	#qum# La tortuguilla terminó de comer el frijol	                   
Wu jaws kkeʼxik chu kʼej	#qum# L a haba se muele para pinol	
Wu chaak kow sichaʼ qal nim xkbʼan ri ajchaak	#qum# El trabajo está duro por eso no avanzaron los trabajadores	                         
Wu nima xbʼoʼj leʼlik wu rchiʼ	#qum# La olla grande es de boca grande	             
Ri nooy kiʼ qʼoxwik ri rbʼaqil	#qum# La abuela le duele su hueso	         
Tkaal xkmik ri ntzʼiʼ rum riʼjaal	#qum# Mi perro se murió despacio ór la vejez	la Comisión adopta actos de ejecución con arreglo al artículo 21 del Tratado que instituye la Comunidad Europea.
Pri molbʼeem xaq kʼeebʼ ixoq xoʼpnik	#qum# En la reunión llegaron solo dos mujeres	la mesa de la mesa
Saqsi xkojyolwik chqatziij rtqriq kʼchiʼ ri utziil	#qum# Si hablamos con la verdad	El cuadro de la planta de la planta
Pri uleew kʼolik kʼiy amluʼx abʼaj	#qum# En el terreno hay montones de piedras	la navega
Rech qal xkojyolik, utz xttojik ri kʼaas	#qum# Para que no nos critiquen es bueno pagar la deuda	                                                                                                  
Ri tikʼlik yaʼ qal utz kumu kiʼ poqʼnik ri raal us	#qum# Las aguas estancadas no es bueno	                                                         
Ri tzʼiʼ xwos	#qum# El perro es travieso	Other articles of heading No 1
Kʼolik ri wnaq qal knmaj ri tyoox	#qum# Existen personas que no creen en las imágenes	              
Che rajlbʼaal rkʼosbʼik r i wtziik	#qum# Que fecha nació mi hermano	La Comisión ha decidido prórroga el periodo de vigencia del acuerdo
Ri nchuch yaabʼ rukʼ rqul	#qum# M i mamá está enfermo de la tos	la Comisión adoptará actos de ejecución de conformidad con el artículo 21 del presente Reglamento.
Ri ajkuun tlaʼ kʼolik rchoch waʼchiʼ rbʼiʼ oxchʼuʼk	#qum# la comadrona vive en el traingulo	                          
Ri rchaq akʼ utz xtqajik chxeʼ ri tikaʼ	#qum# La gall inaza es bueno para abonar la siembra	           
Ataq kʼolik yaʼ tikʼlik xibʼal serat kiʼpoqʼnik	#qum# Cuando hay charcos de agua	Attaq kʼolik yaʼ tikʼlik xibʼal serat kiʼpoqʼnik es el primer día de la semana.
ajsik xokul ri elqʼoom sicha ʼ qal xnaʼ ri tzʼiʼ	#qum# El ladrón entró arriba por eso no se dio cuenta el perro	A      
Ataq xkʼosbʼik ri ajkʼaal rbʼaqʼtmaj riibʼ ri rkʼamaʼl rmuux pirqul	#qum# Cuando nacio el niño lo	El artículo 21 del Reglamento Financiero
Ri keej bʼilbʼik wu rbʼaq rwoch	#qum# El caballo tiene los ojos grandes	la Comisión se fija la lista de los datos que se pueden obtener en la página de la página de la página de la página de la página de la página de la página de la página de la página de la página de la página de la página de la página de la página de la página de la página de la página de la página de la página de la página de la página de la página de la página de la página de la página de la página de la página de la página de la página de la página de la página de la página de la página de la página de la página de la página de la página de la página de la página de la página de la página de la página de la página de la página de la página de la página de la página de la página de la página de la página de la página de la página de la página de la página de la página de la página de la página de la página de la página de la página de la página de
El cuarto lo han barrido	#qum# Barrendero	The room is swept .
Ri nchuch utz keʼrbʼan ri xkulbʼal	#qum# Mi mamá puede hacer petate	El cuadro de la información que se puede hacer
Ri pisbʼal ri juuj bʼantlik rukʼ miit	#qum# La en voltura del papel está hecho de algodón	La Comisión se fija el artículo 23 de la Directiva 2006/65/UE
Njeel ri kʼyeej itzʼaplik	#qum# Todos los negocios están cerrados	              
Xsqarsxik ri riil ri achii se aclaró el delito del hombre	#qum# Dirrecion	The man's crime was clear.
Chpom ri bʼeey xtukxik poqlaaj	#qum# En el camino se regó arena	la que la gente se va a la casa
Ri sʼaq tʼaq	#qum# La ropa está mojada	️ El cuadro de la vida
Ataq xsiq ri tzʼiʼ ri qan chkop xtrambʼeej rech xwiʼtaaj	#qum# Cuando el perro olió las huellas del	    
Ri aliit xtzaqeel wu rkaʼ	#qum# La señorita se le cayó la muela	La Comisión adoptará actos de ejecución en conformidad con el artículo 21 del Reglamento Financiero.
Ri tzʼiʼ xsok ri achii pirsmoqʼ	#qum# El perro lo hirió al hombre en la fosa poplítea	        
Ri siikʼ kirbʼan kʼex chu ri tzantzqʼor	#qum# El consumo del cigarro daña el cerebro	La Comisión adoptará actos de ejecución con arreglo al artículo 21 del Reglamento Financiero
Ataq kpetik jabʼ wu kʼotzʼaj qʼus kkaʼyxik	#qum# Frijol	I'm not sure what to do.
Ataq utz bʼanmaj ri chaak qal chik ktzuntzxik	#qum# Cuando está bien hecho el trabajo no es necesario repasarlo	la Comisión adoptará actos delegados de conformidad con el artículo 21 del Reglamento Financiero.
Ri ajmaak areʼ ri achi i ri xwiʼt aaj ri ixoq	#qum# El hombre que mató a la mujer es el culpable	         
Ri saqkʼim kchuknik chu kbʼanik xuʼk	#qum# El pajon blanco sirve para elaborar canastas	n'a pas dire quoi que ce soit.
Latzʼ wu rpom jaay sichaʼ qal xiʼ kʼisook njeel ri wnaq	#qum# La casa es muy reducido por eso no	                                                                                                  
Ataq kqajik ri nabʼey rqan jabʼ keʼlul ri xkawalek	#qum# Cunado cae las primeras lluvias salen	          
Ri xbʼaj kirbʼan kʼex chu ri qsosobʼ	#qum# El aguardiente causa daños a nuestro hígado	(C) la luna se va a pasar
Xeʼ taq ri abʼaj kiʼkʼobʼik ri kmatz	#qum# Debajo de las piedras están las culebras	He's got a lot of things to do.
Ri tikaʼ kkʼiyik rum ri rmeqʼnal ri qʼiij	#qum# La siembra crece con el calor del sol	la la que sea la ley
Waqiibʼ iikʼ chi k xtqajik raal wu wakx	#qum# Entre seis meses va parir la vaca	️️️️️️️️️️️️️️️️️️️️️️️
Jun mlol ylooj xb ʼiʼnik re waʼ	#qum# Esto lo dijo un chismoso	La Comisión ha adoptado una propuesta de reglamento sobre la aplicación de la directiva sobre la aplicación de la directiva sobre la aplicación de la directiva sobre la aplicación de la directiva sobre la protección de los
Ri albʼatz xyoʼqook chu rqirxik ri rwoch ixiim	#qum# La nuera se le puso a	         
Pirwiʼ ri jyubʼ xeʼqbʼnaʼ ri chʼabʼal maaya	#qum# En la cima del cerro fuimos hacer la ceremonia maya	#  # #  # # # # # # # # # # # # # # # # # # # # # # # # # # # # # # # # # # # # # # # # # # # # # # # # # # # # # # # # # # # # # # # # # # # # # # # # # # # # # # # # # # # # # # # # # # # # # # # # # # # # # # # # # # # # # # # # # # # # # # # # # # # # # # # # # # # # # # # # # # # # # # # # # # # # # # # # # # # # # # # # # # # # # # # # # # # # # # # # # # # # # # # # # # # # # # #
R i alaabʼ xtochʼ ri rqan rukʼ ri tochʼbʼal	#qum# El muchacho se cortó el pie con el machete	                      
Ri elqʼoom chaqʼabʼ xkelqʼaaj ri rwaakx wjow	#qum# Los ladrones de noche robaron la vaca de mi papá	        
Ri nanyoox xaq kyabʼabʼ ik rum wu re tzaʼm	#qum# la señora siempre padece del catarro	           
Najeʼl xbʼan ri wtziik ri rchoch	#qum# Mi hermano construyó su casa retirado a la mia	No voy a decir nada.
Ri aliit nmaq wu riim	#qum# La señorita tiene los pechos grandes	El cuenta la mano
Ri rbʼuch akʼ xnojik rukʼ rwoch ixiim	#qum# El buche de la gallina se llenó con granos de maíz	la Comisión se fija la leyenda de la ley de la ley de la ley de la ley
Pri ntinmit qal kʼiy moos ikʼolik	#qum# En mi pueblo hay pocos ladinos	La Comisión se aprueba el artículo 21 del Reglamento Financiero
Ri tzʼuum xchiqik chu qʼiij	#qum# El cuero se secó en el sol	la Comisión la adopte actos de ejecución de conformidad con el artículo 21 del Tratado.
Ri ajkʼaal yaabʼ sichaʼ qal ktzeʼnik	#qum# El niño está enfermo por eso no puede reir	
Wu us qal utz laj chkop kir chʼulchʼaʼ ri che ri qtij	#qum# La mosca es un animal malo porque contamina lo	                               
Ataq kiʼ waʼljik ri ajkʼalobʼ konjeel keʼ bʼixnik	#qum# Cuando los niños se levantan todos cantan	Attaq ki' wa'ljik ri aj'alob konjeel ke' b'ixnik es la primera vez que las dos partes se encuentran.
Chke ri ajkʼalobʼ riliil rij xkeʼtijxik rech xkeʼqʼajlaʼnik	#qum# A los niños es necesario enseñarles a saludar	a ko si to toe.
Ri ajtzʼibʼnel xeʼrtzʼibʼaaj kʼiy q taʼ pqyolbʼaal	#qum# El escritor escribió varios cuentos en el	                                                                                                  
Ri ixoq xtzʼonjok jrubʼ rjil wu akʼ	#qum# La señora preguntó cuanto vale la gallina	la que la gente se ve la gente se ve la gente se ve la gente se ve la gente se va a la gente se va a la gente se ve la gente se va a la gente
wu klobʼ xyuqpjik ataq xchnaʼnik	#qum# El lazo se estiro porque se mojó	la Comisión se fija la ley de la ley
La laga rtija sale cuando hay sol	#qum# Sapo	️️️️️️️️️️️️️️️️️️️️️️️️️️️️️️️️️️️
Ri xaʼk chqiʼj chik	#qum# El trozo ya está seco	        
Ri xenxipr utz chi kunbʼal ri qulaj	#qum# Para curar la tos es bueno el jengibre	La Comisión ha adoptado una propuesta de reglamento sobre la protección del medio ambiente
Ri klobʼ ktumxik rukʼ xweelx	#qum# El laso lo hacen torcer con malacates	El Consejo de la Unión Europea
Ri ryaʼl tzmeʼy utz xtqum jun ixoq rech q al ri raal xtokʼwik	#qum# El agua de la	        
Ri qʼabʼreel pakʼlik xkanjik ataq xtzaqik	#qum# El borracho cuando cayó quedó de boca arriba	I'm not sure what to do.
Ri achii ataq xbʼeek chu rkʼamik siʼ qal xkʼambʼik ri rptem	#qum# El hombre cuando se fue a traer leña no llevó su mecapal	
Junbʼer xkʼuqbʼsxik ri rwiʼ rqʼabʼ tinmit	#qum# El año pasado se fundó el caserío	                                                                                                  
Njeel jnobʼ kbʼanik ri nimaqʼʼij	#qum# Rech ri tinmit	msaḥ msaḥ 
Ri ixoq xpe saqtqoj chriij	#qum# A la mujer le dió vahído	      
Ri alaabʼ xtzaqik xqʼoch wu rqʼabʼ	#qum# El muchacho se cayó y se quebró la mano	I am not sure if I can tell you that I am not a member of the European Parliament.
Ri wtziik xaq xchʼutij ri rchoch	#qum# Mi hermano apuntaló su casa	El Consejo de la Comisión
Chqʼayaʼpon ri yaʼ kʼolik rchoch ri Leʼn	#qum# al otro lado del rio está la casa de Elena	                                                                                                  
wu ekʼaʼ kchuknik chu wiqbʼal	#qum# La cola de gallo sirve para adornar	La Comisión se aprueba el acto de ejecución
Iwir xintzaqken ri qʼaxbʼal chaʼnbʼal ayer perdí el teléfono	#qum# Dolor	I'm a little bit off the grid yesterday I lost my phone
Ri wkaan kʼolik kʼeebʼ rmyaʼlbʼaal	#qum# Mi tío tiene dos hijastras	Ri wkaan kʼolik kʼeebʼ rmyaʼlbʼaal es el primero de su clase en el mundo.
Ri saqʼuul xaq tqʼaaj kiryaʼ wiʼ, El plátano solo se da en la costa	#qum# Palo blanco	## ## La banana solo viene de la costa #
Iwir xqʼeq xojkʼobʼik pjun molbʼeem	#qum# Ayer en la tarde estuvimos en una reunión	Iqeq q 
Ri ajkʼaal riliil rij kyuqxik chu ri rqʼabʼ	#qum# El niño se debe agarrar de la mano	                 
Ri ajtiij xkʼuqbʼaʼ ri tatanool chu teem	#qum# El maestro lo mando a serntar al abuelo en la silla	I'm not gonna say anything about it.
Qonjeel qqum qʼoor	#qum# Todos tomamos atol	️️️️️
A qué hora nos vamos al entierro	#qum# Dentro de un año	A a a a a a a a a a a a a a a a a a a a a a a a a a a a a a a a a a a a a a a a a a a a a a a a a a a
Wu loʼn nmaq kkaʼyxik	#qum# Las frutas se ven grandes	       
Ri kuch xibʼal squkʼ chriij	#qum# El cerdo tiene mucho piojo	️️️️️️
Ri lochʼ qal xchʼij ri qʼaaqʼ xelul chriij	#qum# El bebé no aguantó la fiebre	                                                                                                  
Ri aliit ataq kbʼeek pchʼiichʼ kiryaʼ xaʼw chre	#qum# la señorita cuando viaja en carro le da vómito	                                                                                                  
Ri winaq keʼchʼoʼ jnik chrij ri yaʼ	#qum# La gente pelean por el agua	                                                                                                  
Ri wjow njeel qʼiij qal jamlik	#qum# Mi papá todos los días se mantiene ocupado	                                 
Chu wu jaay rech chʼabʼal kʼolik kʼeebʼ mulmik uleew	#qum# En frente la iglesia	                      
Ri cheʼ qʼeʼlik xk anjik pri bʼeey	#qum# el árbol quedó atravesado en el camino	I am not sure what to do .
Ri chiij qʼeqqʼoj rkaʼybʼaal	#qum# El color de la oveja es medio negro	                   
Riliil riij ataq xtqum ri yaʼ nabʼeey xtrqowsxik	#qum# Es necesario cuando tomamos el agua	️️️️️️️️️️️️️️️️️️️️️️️️️️️️️️️️️️️️️️️️️️️️️️️️️️️️️️️️️️️️️️️️️️️️️️️️️️️️️️️️️️️️️️️️️️️️️️️️️️️️
Ri rwoch tikaʼ kkiʼyrik rum wu rtun qʼiij	#qum# La fruta se endulza con los rayos del sol	la Comisión se aprende la ley de la ley de la ley de la ley de la ley de la ley
Ri rwoch nuxtaʼ xibʼal rkʼixil	#qum# La fruta del nopal tiene mucha espina	       
Ri aliit kiryqʼuj ri ajkʼaal	#qum# La señorita c uida al bebé	       
Chpom ri yaʼ piʼlik xibʼal xaʼn	#qum# En el agua encharcada hay mucho zancudo	mn  mn                                           
Ri tzʼiʼ ktzʼuʼynjik ataq kirkaʼyij wu rxoqʼjowil	#qum# El perro ronronea cuando mira su	La Comisión ha decidido prorrogar el periodo de validez del acuerdo.
Ataq xojopnik jaqlik chik ri rchiʼ jaay jroq koʼkik elqʼoom	#qum# Cuando llegamos ya estaba abierto la	La Comisión aprueba actos de ejecución de conformidad con el artículo 21 del Reglamento Financiero.
Ri ajkʼaal xyabʼrik rukʼ xjir	#qum# El niño se enfermo de dearrea	                                         
Ri snik ktij ri rxiʼl leej	#qum# Las hormigas comen la migaja de tortilla	la Comisión apruebe actos de ejecución de conformidad con el artículo 21 del Tratado.
Ri kiʼ wiqnik ri nima qʼiij areʼ ri qʼus laj taq ixoq	#qum# Los que engalanan la fiesta son las bellas mujeres	                                                                                                  
Ri traas spoqʼpoj rtijik	#qum# El durazno está desabrido	Tu bringas el rtijo de la mierda
Ri wiqabʼaaq kchuknik chu ri qʼajaʼ	#qum# La sábila es bueno para las quebraduras	La Comisión aprueba actos de ejecución de conformidad con el artículo 21 del Reglamento Financiero.
Ri ajkʼa al qal chik xtuʼnik rum wu xsopjik wu rqul	#qum# El bebé ya no pudo mamar porque se le	                                                                                                  
Qonjeel wu ojkʼolik chu rwoch paxil nkareʼ xaq jnum ri qbʼanbʼaal	#qum# Todos los	El día de la mañana se va a pasar
Ri alaabʼ xwiʼtaj jun kuuk rukʼ ri r chʼaabʼ	#qum# El m uchacho mató una ardilla con su onda	                                                                                                  
Ri rchʼeek wtziik xqʼajik ataq xtzaquul jun xaʼk chriij	#qum# La rodilla de mi hermano se quebró cuando le cayó un trozo encima	️ La Comisión ha decidido tomar las medidas necesarias para garantizar que la Comisión pueda tomar todas las medidas necesarias para garantizar que las medidas adoptadas se aplican en consonancia con los objetivos del programa
Ri wurbʼal kchʼajchʼtik	#qum# El dor mitorio es limpio	El Consejo de Seguridad Nacional (CFP)  El Consejo de Seguridad Nacional (CFP)  El Consejo de Seguridad Nacional
Ri chʼiichʼ suukʼ xbʼeek pswon	#qum# El carro se fue directo al barranco	              
chpom ri uleew kʼiy kʼulbʼat ikʼolik	#qum# En el terreno hay varios muros	            
Jumul xtbʼiʼxik ke ri qatz riliil riij areʼ ri nimneem	#qum# Una vez se dice que lo más importante es el respeto	la Comisión se aprende la ley
Ri ryaʼl iik tzeytzoj xelik	#qum# El caldo salió medio salado	la forma de la nave se va a la casa de la nave
Ataq kojbʼinik nim tʼuus keʼlik ri qqan	#qum# Cuando caminamos mucho los pies nos	                   
Ataq xinsol ri kʼaam xinbʼotzʼ chrij jun piʼq	#qum# Cuando desaté la pita es fácil arrollar en un olote	La Comisión adoptará actos de ejecución de conformidad con el artículo 21 del Reglamento Financiero.
Xibʼal rkʼixil ri yeel	#qum# El chichicaste tiene mucha espina	         
Pri nimaqʼiij xeʼchuknik kʼeebʼ ulanel	#qum# Para la fiesta trabajaron dos recepcionista	️️ ️️️️️️️️️️️️️️️️️️️️️️️️️️️️️️️️️️️
Chke xyoʼqik njeel ri poq chi rbʼanik ri nimaqʼiij	#qum# A ellos les dieron el dinero para hacer la fiesta	                                                        
Ri wkaaqʼ areʼ jun utz laj achii	#qum# Mi sobrino es un buen hombre	                                    
Ri tzʼuu m likʼmaj rwoch chu uleew	#qum# El cuero estaá extendido en el suelo	I'm not sure what I'm saying.
Rum wu qal tzʼqaat ri rpajbʼaal ri ajkʼeynel sichaʼ xbʼeek pcheʼ	#qum# Por estar	
Ri qʼoor qal xqumik kʼten xtewrsxik tekʼchi xjachik	#qum# El atol no se pudo tomar	Nemem se vou conseguir copiar isto.
Ri wakx jurjik ri raaqʼ La vaca tiene la lengua larga	#qum# Temascal	# La vaca tiene una lengua larga
Qal utz xtqyaʼ jun che chqoom ri wnaq kʼa krechbʼeej	#qum# No es bueno prestar algo a alguien porque se adueña	A A A A A A A A A A A A A A A A A A A A A A A A A A A A A A A A A A A A A A A A A A A A A A A A A A A A A A A A A A A A A A A A A A A A A A A A A A A A A A A A A A A A A A A A A A A A A A A A A A A
Ri tzʼuum ri kʼaʼn chu ri kʼuqulbʼal mixjarik	#qum# El cuero que tiene el sentadero se	              
Ri achii ataq kir bʼan ri awaʼn kertaqiij ajchaak chu rtoxik	#qum# El hombre cuando siembra busca	a la Comisión se fija la agenda de la semana
Xkmik ri tʼuq laj akʼ	#qum# La gallina clueca se mur ió	                               
Ri nchuch xloqʼ jun suʼbʼal qʼabʼ	#qum# Mi mamá compró una servilleta	                                   
Utz xtqsipaj ri poq nuʼj chke ri mebʼaʼ	#qum# es bueno regalar dinero pero a los huérfanos	la la que se le ocurre la que se le ocurre la que se ocurre la que se ocurre la que se ocurre la que se ocurre la que se ocurre la que se ocurre la que se ocurre la que se ocurre la que se ocurre la que se ocurre la que se ocurre la que se ocurre la que se ocurre la que se ocurre la que se ocurre la que se ocurre la que se ocurre la que se ocurre la que se ocurre la que se ocurre la que se ocurre la que se ocurre la que se ocurre la que se ocurre la que se ocurre la que se ocurre la que se ocurre la que se ha de la que se ha de la que se ha de la que se ha de la que se ha de la que se ha de la ha hecho
Ri wchoch rex ri rkaʼybʼaal	#qum# Mi casa es de color v erde	a) a) la Comisión se pronuncia sobre la cuestión de la aplicación de la ley
Ataq kʼolik muuj chukaaj retal kʼchiʼ kpetik jabʼ	#qum# cuando hay nube en el cielo es seña que	                                                                                                  
Ri raal kuch xiʼ qajik tiʼt njeel	#qum# Las crías de la marrana que cayero son hembras	## ## ## La gente se va a la mierda
Ri nchuch xproj ri rtkuʼl	#qum# mi mamá lo quemó su paleta	la Comisión se aprueba de actos de ejecución en conformidad con el artículo 21 del presente Reglamento
Ri rtibʼliil woy chetzʼini k rtijik	#qum# La comida es bien ssabrosa	️️️️️️️️️️️️️️️️️️️️️️️️️️️️
Ataq xojelpoon chu ri ilbʼal qʼus rkaʼyxik ri tinmit	#qum# Cuando salimos al mirador el pueblo se mira bello	La Comisión adoptará actos de ejecución de conformidad con el artículo 21 del Reglamento Financiero.
Wu chʼmaay utz xtktij ri ajkʼlobʼ rech xtkʼobʼik kchoqʼaabʼ	#qum# El guisquil es bueno que	                                                                                                  
Ataq xkmol kiibʼ ri aloʼm xkbʼanken jun etzlaal chu ri qtikaʼ	#qum# Cuando se reunieron los	                               
Ri wxqʼajlobʼ tarnuul chwij mi compañero viene atrás	#qum# Escuela	                                                                                                  
Ri ixoq kirjokʼ ri skiil chu kaʼ	#qum# La mujer muele la pepita de ayote en la piedra de moler	la Comisión debe adoptar actos de ejecución en conformidad con el artículo 21 del Reglamento Financiero.
Wu musmut utz chi qʼxom kʼuʼxaj	#qum# El ajenjo es bueno para el dolor de estómago	                  
Ri n tatanool nim ri retambʼal	#qum# Mi abuel o posee grandes conocimientos	            
Don Jesus se puso la camisa al revés	#qum# Escama	Don Jésus a mis la camise sur l'autre côté
Ri toch ʼaʼ kirtij ri rwoch nuxtaʼ el jilguero c ome la fruta de la tuna	#qum# Pagar	
Ri cheʼ pujpik sichaʼ kiryaʼ muʼj	#qum# el árbol es frondoso y da buena sombra	                   
ataq xinbʼan ri wchoch xinbʼan jun jloom	#qum# Cuando construí mi casa tuve que hacer un préstamo	              
Ri saqtbʼiin jurjik wu rjey	#qum# La comadreja tiene la cola larga	la Comisión se encarga de la gestión de la salud
Kʼa xaq et rchim wu chʼiichʼ xichaʼ qal xchʼij xelbʼik chu wu rujyubʼ	#qum# Por mucha carga el carro no aguantó salir en la subida	                                                                                                  
Ri rchak ri ixoq kirbʼan njeel qʼiij areʼ ri tʼisneem	#qum# El trabajo que hace la mujer todos los	La Comisión adoptará actos de ejecución de conformidad con el artículo 21 del Reglamento Financiero
Wu jiiqʼ kiryaʼ che ri ajkʼalobʼ	#qum# La tosferina le da a los niños	                                            
Ri aliit qʼus rkaʼyxik kukʼ ri ruwaj	#qum# La señorita se ve elegante con sus collares	                              
Ataq xkʼisik ri molbʼeem ri aloʼm xiʼ tikrook chu ktzʼulxik ri altom	#qum# Cuando terminó la	La Comisión aprueba actos de ejecución de conformidad con el artículo 21 del Reglamento Financiero
Wu chʼikaʼx xuqkee kchuknik chi siʼ	#qum# La chicharra de pino tambien se usa	                      
En el techo de la casa hay dos agujeros	#qum# Semana	There are two holes in the roof of the house.
Ri chaak xaq che rbʼ anik sic haʼ xqtzuntzaj	#qum# El trabajo quedó mal hecho por eso se	            
Aqʼabʼ xelbʼik ri achii chi rawxik ri chnooj	#qum# El hombre salió temprano a sembrar la	La Comisión se ha de adoptar actos delegados en conformidad con el artículo 21 del Reglamento Financiero.
Xibʼal xibʼaliibʼ chu ri wiʼtnel	#qum# Hay mucho miedo al asesino Ciprés	️️️️️️️️️️️️
X kʼatik ri rtzʼumil rqʼabʼ ri ixoq	#qum# a la señora se le quemó la piel de la mano	        
Jrubʼ rajlaal ri poq xeʼloq	#qum# Cuanto ascendió la cantidad del dinero	# La Comisión debe adoptar actos de ejecución con arreglo al artículo 21 del Reglamento Financiero
Qaqchee chik ri k ʼ yeej kumu xchupik ri rxoqʼjowil	#qum# Ya no hay venta porque se murió el dueño Bellota de arboles	## ##### #### La vida de la gente es muy buena
Ri ixoq xbʼeek chi rtaqxik qʼaʼtzuy praal cheʼ	#qum# La mujer fue a buscar hongo en la	la Comisión ha decidido por la prórrogación del periodo de vigencia del acuerdo a los Estados miembros.
Paqʼiij xoʼkik ri elqʼoom pjaay elqʼnel	#qum# De día ent raron los ladrones en la casa a robar	                          
Ri qbʼey xsukʼbʼik kumu xqjnumsaj ri qchoqʼaabʼ	#qum# Nuestro camino se	La Comisión adoptará actos de ejecución en conformidad con el artículo 21 del Reglamento Financiero.
Ataq xtzaqik ri ajkʼaal xelul kikʼ pirtzaʼm	#qum# C uando cayó el niño le salió sangre en la nariz	        
Ri wochbʼlaal areʼ jun naʼtbʼal qe	#qum# El retrato es algo que nos recuerda	### # La vida es muy buena
Ataq xi bʼal kqʼiiqʼ ri rwiʼ jaay ktzalbʼik	#qum# Cuando hay mucho aire el techo de la casa	La Comisión adoptará actos de ejecución de conformidad con el artículo 21 del Reglamento Financiero.
Ri raal chiij ktuʼnsxik kumu qal xpon rqʼij	#qum# La cria de la oveja lo amamantan porque	       
Ri yaak xeʼrtij ri raa l akʼ	#qum# El gato de monte se comió todos los pollitos	I'm not going to say anything.
Ri rkʼoʼxiil ubʼooy kchuknik chu awbʼal	#qum# La	la Comisión de la Cumbre de la Cumbre de la Cumbre de la Cumbre de la Cumbre de la Cumbre de la Cumbre de la Cumbre de la Cumbre de la Cumbre de la Cumbre de la Cumbre de la Cumbre de la Cumbre de la Cumbre de la Cumbre de la Cumbre de la Cumbre de la Cumbre de la Cumbre de la Cumbre de la Cumbre de la Cumbre de la Cumbre de la Cumbre de la Cumbre de la Cumbre de la Cumbre de la Cumbre de la Cumbre de la Cumbre de la Cumbre de la Cumbre de la Cumbre de la Cumbre de la Cumbre
Ri aliit qal kirkʼut saqsi tzʼeebʼ	#qum# A la muchach a no se le nota que es tartamuda	                                                                                                  
Ri achii xrubʼaaj ri musaat rukʼ ri ubʼ al	#qum# El hombre mató el venado con su	a) La Comisión se encarga de la gestión de la gestión de la gestión de la gestión de la gestión de la gestión de la gestión de la gestión de la gestión de la gestión de la gestión de la gestión de la gestión de la gestión de la gestión de la gestión de la gestión de la gestión de la gestión de la gestión de la gestión de la gestión de la gestión de la gestión de la gestión de la gestión de la gestión de la gestión de la gestión de la gestión de la gestión de la gestión de la gestión de la gestión de la gestión de la gestión de la gestión de la gestión de la gestión de la gestión de la gestión de la gestión de la gestión de la gestión de la gestión de la gestión de la gestión de la gestión de la gestión de la gestión de la gestión de la gestión de la gestión de la gestión de la gestión de la gestión de la gestión de la gestión de la gestión
Ri rchiʼ jaay xpaqʼtjik rum ri rkabʼ rqan	#qum# la puerta de la casa se partió por el temblor	la que la gente se ha visto la gente se ha visto la gente se ha visto la gente
Ri wnobʼ yuux ri raal	#qum# Mi hernana tiene gemelos	La Comisión se encarga de la ejecución de la aplicación de la letra a) del artículo 21 del presente Reglamento
Ri tzʼiʼ xelul qʼaaqʼ chriij	#qum# Al perro le dio fiebre	El artículo 21 del presente Reglamento se aplica al artículo 21
Ri tatyoox qal chik kirchʼij rjoʼxik ri rsomchiʼ	#qum# El anciano ya no aguanta afeitarse	       
Njeel ri ajchaak xeʼyoʼqook chu rpaqʼik ri uleew	#qum# Todos los trabajadores les pusieron a	La Comisión adoptará actos de ejecución de conformidad con el artículo 21 del Reglamento Financiero
Njeel ri ajchaak xeʼtobʼik chu rmolik ri abʼaj	#qum# T odos los trabajadores ayudaron para juntar la	La Comisión adopta actos de ejecución de conformidad con el artículo 21 del Reglamento Financiero.
Wu ulee w naʼl xtzʼaqik	#qum# La tierra se tiene que compactar bien	          
Ri wix kir qchʼuj ri paan	#qum# El gato le dió un mordisco al pan	 
Ataq xojelbʼik qonjeel x qtzʼap ijken ri rchiʼ jaay	#qum# Cerrado	           
Ri rchʼmeʼy ntatanool xq ʼajik	#qum# El bastó n de mi abuelo se quebró	No, no, no.
Ri abʼaʼ bʼantlik rukʼ saqkiiy	#qum# La hamaca está hecha de pita de mecate	Ri abʼaʼ bʼantlik rukʼ saqkiiy
¿Cuánto cuesta el sombrero que compró mi mamá en la plaza	#qum# ¿cuándo?	oooooooooooooooooooooooooooooooooooooooooooooo
R i achii xelbʼik rukʼ ri rtzʼiʼ chu rtaqxik ri musaat	#qum# El hombre salió con su perro a cazar	        
Ri chʼooy xchʼulchʼaʼ ri ixiim	#qum# El ratón ensuscio todo el maíz fracción/ pedazo	                                  
Njeel ri wnaq nim ri knoʼj sichaʼ utz ikʼolik	#qum# Toda la gente tienen buena ineligencia por eso están bien	 
Ri nchuch xtzaltzaj ri poʼt ri xloqʼ kumu nuchʼ xkanaj chriij	#qum# Mi mamá tuvo que	la Comisión se fiera de la forma de la forma de la
Ri keqʼ kiryaʼ ptaq ri rqan swon	#qum# La Guayaba se da en los barrancos	        
Ri kuch xkchʼulchʼaʼ ri kwoy	#qum# Los c erdos ensuciaron la comida	           
Cuando oímos el río tumbar rápido corrimos	#qum# Bejuquillo	️ When we heard the river falling fast we ran
Ajwiʼ xtpetik jabʼ rukʼ saqbʼuch	#qum# Hoy va llover con granizo	I'm not sure what I'm saying.
Ri tzʼiʼ xkbʼalktij kiibʼ rukʼ ri sjiʼl	#qum# El perro se revolcaron con el coyote	La Comisión adoptará actos de ejecución de conformidad con el artículo 21 del Reglamento Financiero.
Riliil riij ataq xkojwaʼljik xkojtyoxnik chu Ajaw	#qum# Es necesario cuando amanecemos debemos agradecer a Dios	La Comisión ha decidido prorrogar el periodo de validez del acuerdo.
Kqʼoxwik ri nxkin	#qum# Me duele el oído	               
Ri ntzʼiʼ naqʼtlik kirtij iik	#qum# Mi perro está acostumbrado comer chile	la Comisión se va a aplicar la Directiva de la Comisión de la Unión Europea
Ptaq ri rqan swon kiryaʼ xibʼal ri chibʼaʼ	#qum# En los barrancos se da mucho el helecho	      
R i ajtʼisnel xwiʼtxik kum ri elqʼoom	#qum# El sastre fue matado por los ladrones	la Comisión se ha pronunciado en la primera palabra
Ri ajtiij xbʼ iij chke ri ajtijnel kʼotz kixkʼ olaq	#qum# El maestro dice a los estudiantes que guarden	           
Ataq xeʼriqtjaq ri ixoq juplik bʼanmajken chre	#qum# Cuando le fueron a encontrar a la mujer la	a) la Comisión no se apruece la solicitud de la fecha de la solicitud
La orina apesta mucho cuando hay mucho calor	#qum# Camarón	
Nim ri kaʼy kbʼanik chu ri waʼktbʼal	#qum# Mucha diversión se hizo en el parque	                              
Ri yaaj utz xttijxik chke ri ajkʼlobʼ	#qum# El regaño es bueno enseñarles a los niños	                                                                                                  
Wu kuuk xkʼis ri a j chtijik	#qum# La ardilla se terminó de comer los elotes	                                                                                                  
