input	reference	prediction
wu rxqiil taʼ xuux xaq utz laj siʼ kchuknik chre	#qum# La esposa de don Jesus solo utiliza buena leña	#qum# La mujer se ha hecho el uso de la
Njeel ri xkarawaʼn xpochʼik rech chenim xchaqʼjik	#qum# Todo la arveja se	# Cuando se despierta la casa de la mujer
Pri qtinmit qal chik kchkunsxik ri qyolbʼaal	#qum# En nuestro pueblo ya no se usa nuestro idioma	# El hombre que se ha quedado en la casa
Ri ajtijnel tjin kirtijuuj c hemo rchkunsxik ri suʼ	#qum# El estudiante está aprendiendo como	#qum# El hombre se ha ido a la casa
Ri ixoq tzʼulmaj rum ri rchjiil	#qum# La mujer estaba abrazada por su marido	# El hombre que se ha ido
Rukʼ taʼ Francisco chwaʼq xtbʼanik awaʼn	#qum# Mañana van a sembrar con don Francisco	El hombre que se ha hecho el hombre que se ha hecho el hombre que se ha hecho el hombre
Chwoch ri jaay kʼolik jun tzʼapiibʼ	#qum# Alrededor de la casa hay un cerco	Mi señorita se lo ha hecho
Los jóvene s todos los días juegan en el campo Perjuicio	#qum# Ataq	# El hombre que se ha quedado en la casa
Ataq xchupik ri nchuch xinkanajken pri bʼiis	#qum# Cuando murió mi mamá me quedé en la tristeza	#qum# La mujer se ha ido a la
Ri ixoq xchupik rum wu rchuch rkʼuʼx	#qum# la mujer se murió de la matriz	#qum# El hombre se levanta
Oxej xtqriq qiibʼ chi ryolik ri chaak	#qum# Entre tres días nos encontramos para platicar del	# El perro se despierta cuando se levanta
Chke ri ajkʼ a lobʼ qal utz xtnaqʼsxik ri elqʼneem	#qum# A los niños no es bueno enseñarles a	# El hombre se ha hecho el hombre
Ri rxaq limobʼ utz kchuknik chi ri qʼyees	#qum# La hoja de aliso es bueno para la broza	El hombre se ha ido a la casa
Ri keej xtzaqik rum wu xaq et rchim	#qum# El caballo se cayó por mucha carga	La gente no sabe que la gente tiene que
Ri ajkʼal kjilpji k pri riij loʼn	#qum# El bebé resbaló en la cascara de la fruta	# El hombre se ha echado la mano
Ri tatyoox xyaʼken njeel ri uleew chu ri rmon	#qum# El señor le dejo toda la tierra a su nieto	# El hombre que se ha hecho el hombre que se ha hecho
Wu xjabʼ koʼl xiʼ kanajken pirqan wu aliit	#qum# Los zapatos de la señorita les quedo flojo Jaula	#qum# El hombre se ha puesto en la
Wu saqtbʼiin mixeʼrkʼis ri akʼ c htijik	#qum# La comadreja se terminó de comer las gallinas	El hombre que se ha hecho
Kji bʼ nmaq meex xkiʼchuknik rech weʼbʼal	#qum# Cuatro mesas grandes servirán para comer	El niño se ha ido en la casa
Njeel ri tzʼibʼbʼal jachmaj chik chke ri ajkʼalobʼ	#qum# Todos los lapiceros ya están divididos a los niños	El hombre se ha ido a la casa
Ri rqan ooj tjin rchiqik rum wu tzrabʼ	#qum# La mata de aguacate se está secando por el	El hombre se ha hecho con la cabeza
Ataq kojqajbʼik chchiʼ ri yaʼ xibʼal kliswik	#qum# Cuando bajamos a la orilla del río es muy	Com la gente no se ha hecho falta de
Ri achii ataq kirbʼsuj rbʼanik jun chaak, xtbsuj ri qʼiij chu rkʼisbʼaal	#qum# El hombre cuando	# El hombre que se ha echado la cabeza
Tzʼajtzʼik rkaʼyxik ri rwoch ri waakx	#qum# La cara de la vaca se ve alargada	El hombre tiene una hija
Wu am kertij ri us ri ikʼoʼk chu xaan	#qum# La araña come las moscas que están en la pared	#qum# El hombre que se ha mudado
Ataq kpetik nim jabʼ xibʼal ri senyabʼ	#qum# Kkanjik	El hombre que no tiene la mano
Ri wjow kʼiy richlaal sichaʼ qal kkʼuqbʼik chjaay	#qum# mi papá tiene muchos parientes por eso no se mantiene en la casa	# Cuando se ha hecho el trabajo
Ataq kpetik jabʼ njeel ri qʼoos krexbʼik	#qum# Vejez	El hombre se ha ido de la casa
Njeel ri ixiim xpokʼrik	#qum# Todo el maíz se apolillo	#qum# El hombre se ha ido a la casa
Ri uleew tjin rmeqʼik rum wu kʼex ri tjin kirbʼan ri achii chre	#qum# por el daño que el hombre está	El niño se ha ido a la casa
Ri qʼoor chqaam xelul	#qum# La masa salió quebrada	# El perro se mueve a la gente
Ri limeet kchuknik chi r kʼolik ri ryaʼl chʼoxiʼ	#qum# La botella se utiliza para guardar miel	# El hombre se ha sacado que no se ha hecho nada
Joʼ qonjeel rech xkojtaʼtjik che ri qajbʼeej	#qum# Vamos todos para que nos atieden nuestra	# El hombre se ha ido a la mujer
Ri nimaya ʼ xkʼiyik sichaʼ xuʼrmaʼ njeel ri tikaʼ	#qum# El río creció por eso se llevó toda la	# El niño se ha sacado la cama
Jomom ri cheʼ sichaʼ xkʼeq rquljaay	#qum# El árbol es grandicimo por eso le pego el rayo	#qum# El hombre que se ha caído
Ri knaqʼ ri kloqʼik pkʼeybʼal esmaj jun pajbʼal	#qum# El frijol que se compra en la plaza lo	La casa de la madre de la madre de la madre de la madre de la madre de la madre
Ataq kintij knaqʼ kiryaʼ qʼaʼteew chwa	#qum# Cuando cómo frijol me da ardor de pecho	El hombre se ha quedado sin tener
Njeel wu loʼn jexmaj rukʼ qʼatbʼal	#qum# Todas las frutas están rodajeada con cuchillo	El niño se ha quedado en la casa
Iwir ri nchuch xloqʼ bʼatzʼ pkʼeybʼal jaljoj kkaʼybʼaal	#qum# Ayer mi mamá compró hilo de varios colores	#qum# El hombre que se va a la casa se va
Ri elqʼoom xqitxik kum ri wnaq xaq rum wu xrelqʼaaj jun keej	#qum# El ladrón fue arrastrado por las	El hombre se ha hecho el trabajo
Ri rqan kiiy tjin rchiqik rum wu xoʼkik chkop txeʼ	#qum# Las matas de maguey se están secando por la plaga	El hombre que no se ha ido
Ataq ktijik jun chooj nim rkunaal kraaj	#qum# Cuando se come un chompipe quiere mucho	El hombre que se ha hecho el hombre que se ha hecho el hombre
Njeel ri rwiʼ jaay ktzʼujik	#qum# Todo el techo de ,la casa gotea	El hombre que se ha ido a la casa
El enfermo se empeoro porque salio bajo la lluvia	#qum# Quemar bien	## El niño se ha ido a la casa
Ri molbʼeem kbʼanik chwuqubʼ qʼiij	#qum# La reun ion se realiza cada semana	La gente se ha visto en la casa
Ri cheʼ xchiqik ri rxaq	#qum# El árbol se le seco las hojas	#qum# El hombre que se ha ido
Rukʼ wu joʼq keʼ bʼanik qʼus laj alaʼs	#qum# Con el doblador se hacen muñecas decoradas	#qum# El hombre se le dio la vida
Julajuuj chiij xeʼr tij ri sjiʼl	#qum# el coyote se comió l as once ovejas	# El hombre que se ha ido
Ri achii xkʼoxbʼsaj ri rjlom ataq xtzaqik rukʼ ri jochlan chʼiichʼ	#qum# El hombre se go lpeó la	La gente se lo ha hecho cuando se ha ido
Ri knaqʼ saqtbʼin chetzʼiʼnik rtijik pjkʼom iik	#qum# El frujol blanco es delicioso comer en	# Cuando se le dio la vida
El cerdo ensució el maíz	#qum# L avado	El hombre tiene una hija
Ri ixoq kiʼrbʼan ri klobʼ rukʼ ri saqkiiy ri kirbʼan rukʼ ri choʼl	#qum# La mujer hace lasos con la	Com la gente se ha hecho el tiro
Chetzʼiʼnik rtijik ri qʼooqʼ	#qum# El ayote es bien rico pa ra comer	# El hombre que se ama a la mujer
Nqaaj waʼchiʼ xchupik ri rchjiil ri ixoq	#qum# Cerca murió el marido de la mujer	# La mujer se ha hecho el hombre que se le dio la leyenda
Njeel ri subʼ tijmaj rum chʼoo y ataq xojsaqrik	#qum# Todo el tamal estaba comido por las ratas	# El hombre que se ha hecho la
Ataq kiʼjikxik ri cheʼ ri uleew sbʼajbʼoj kkanjik	#qum# Arena	# Cuando se le dio la palabra de la mujer se le dio
Ri tzʼqubʼ kchuknik chu ri jsol cheʼ	#qum# El formón lo utiliza el carpintero	# El hombre está en la casa de la mujer
Ri imul ataq kʼolik rqan iikʼ kelul chirtijik wu knaqʼ	#qum# El conejo cuando hay buena luna sale a comer el frijol	# El hombre que se despiesta de la tierra es un hombre que
Ri ixoq ataq xwiʼtaaj ri akʼ kʼa xlechʼpij ri rtzʼumil	#qum# La mujer cuando mató a la gallina	#qum# Cuando se hace el uso de la sillaba
Ri rjujil uleew xsibʼrik wu riij	#qum# El documeto del terreno está ahumado	El hombre se ha ido a la casa
Ri tzʼtuj ktij tochʼaʼ chu kwoy	#qum# La flor de milpa lo come las chorchas	# El hombre que se ha ido de la casa
Riliil riij xtloqʼxik ri uleew	#qum# Es necesario cuidar la naturaleza	# El hombre que se ha ido a la casa
Ri knimalil ri ajkʼalobʼ ktij tzʼiʼlil	#qum# La mayoría de los niños consumen mucha galguería	#qum# El hombre que se le puso a la
Ataq kokik saqʼiij yaax keʼlik ri waakx	#qum# Cuando entra el verano las vacas se ponen flacos	# Cuando se le dio la vida a la mujer
Ri ajkʼaal xwochʼ wu rwiʼ rqʼabʼ	#qum# El niño se majó el dedo	# La casa de la madre no se ha ido
Ri nchuch xloqʼ ri paa kʼ pkʼeybʼal	#qum# Boca arriba	El niño se ha sacado el pelo
Ri ajkʼaal qal xchʼij kumu kʼten yaʼ xtixuul chriij	#qum# El niño no guantó porque se le regó agua	El hombre se ha hecho el hombre
Wu puʼt kxikʼnik chu taq ri kotzʼaj	#qum# La mariposa vuela entre las flores	# El hombre se ha quedado en la casa
Njeel ri ya abʼ mixuʼtzrik	#qum# Todos los enfermos sanaron	#qum# El hombre que se fue
Ri chnooj xchiqik kumu xqaaj teew chriij	#qum# La milpa se secó porque le cayó hielo	# El hombre se le dio la leyenda
Ri xpley kiryaʼ ataq jnum kawxik rukʼ ri chnooj	#qum# El frijol amarillo da cuando se siembra	El hombre que se ha hecho el trabajo
Ri yaʼ kʼolik rsaqiil	#qum# El agua tiene pureza	#qum# El hombre se ha ido
Jutzʼjik rkaʼxik ri rwiʼ rchoch wjow	#qum# El techo de la casa de mi papá se ve de forma triangulo	# El hombre se ha ido a la casa
Ataq koʼqʼoʼk ri toltol chjaay labʼnel kʼolik chinaq xtkmik	#qum# Cuando el buhuo llega a	Cono la gente no tiene nada que decir
Ri molbʼeem kech ri aj tijnel xbʼanik kabʼjiir	#qum# La reunión de los estudiantes se hizo anteayer	El hombre que se ha hecho el mal
Ri nchuch kʼolik rmkoom	#qum# Mi mamá tiene sirvienta	#qum# El hombre es el que
Ri ajkʼalobʼ xeʼoqʼik rum qal xkchʼak ri etzʼnim	#qum# Los niños empezaron a llorar cuando perdieron	El hombre que no tiene la vida
Ri qyolbʼaal areʼ ri Sipakapense	#qum# Nuestro idioma es el Sipakapense	El hombre se ha hecho
Xaq qiʼn chik qal xmaj qʼaaqʼ ri jun jaay chik	#qum# Por un poco no alcanzo el fuego la otra casa	La mujer de la mujer se ha ido
Ri rbʼaqʼ rwoch wnaq kirbʼan kʼex chke ri ajkʼ a lobʼ	#qum# El mal de ojo les afecta a los	#qum# El hombre que no se ve en la casa
Qal utz xtqtij ri chʼqaap	#qum# No es bueno comer el sobrante al otro día	# Los niños se quedan en la casa
Chke njeel ri wnaq xbʼiʼxik ke qal xeʼlbʼik xkoybʼeej ke xkʼisik ri molbʼeem	#qum# A todas las	El hombre que no se ha ido
Rech ri nima qʼiij rech tinmit qonjeel qyaʼ ri kchuuj	#qum# Para la fiesta del pueblo todos damos la contribución Ri achii xkanajken	El hombre que se ha ido a la casa
Njeel ri chaak ri xbʼanik bʼusmaj riij sichaʼ utz xeʼloq	#qum# Todo el trabajo que se realizó estaba bien pensado por eso salió bien	#qum# El hombre se ha hecho
Tukkilaʼ kʼolik r i rchoch ri wnobʼ	#qum# Por allá está la casa de mi hermana	Com la panza se le va
Njeel ri kotzʼaj ri rawmaj ri nchucch keq rkaʼybʼaal	#qum# Las flores que tiene sembrado mi mamá son de color rojo	El niño se ha hecho el trabajo de la casa
Ri kchak ri ojor wnaq qaqchee chik kiʼ riqt jik	#qum# Los trabajos de los antiguos ya no se encuentran	El hombre que se ha ido a la casa
Ri saqbʼuch xkʼoxbʼsaaj ri chno oj	#qum# El granizo golpeo la milpa	# El niño se le dio la vida
wu ajkʼaal kiryaʼ achyam chre	#qum# Al niño le da estornudo	La gente se ha ido a la fiesta
Pongale una cuña a la mesa	#qum# Codo	#qum# La mujer se ha quedado en la casa
Cha niim xojelbʼ ik sichaʼ xojtz aljuul jnum	#qum# Salimos rápido por eso regresamos juntos	La casa de la mujer se ha hecho
Ri rtzʼibʼbʼaal ri ajtijnel xqʼeptjik	#qum# El lápiz del estudiante se quebró	El hombre que no se le dio la vida
Ri rwiʼ ri aliit pochʼmaj rukʼ ri rxqʼap	#qum# El cabello de la señorita está trensado con su	# El hombre que se ha hecho el hombre que se ha hecho
Chu ri qʼtal iil qal ri tzujnel xopnik	#qum# Ante el juez no se presentó el acusador	# El hombre que se ha ido de la casa
Estaba mojado la camisa del hombre por eso le dio fiebre	#qum# C ama wu chʼaat bʼantlik rukʼ	El hombre que tiene la cabeza en la mano
ri achii kʼolik rsmaal chu rkʼuʼx	#qum# El hom bre tiene bellos en el pecho	#qum# El hombre se ha quedado
La tabla es ancha	#qum# Pizarron	El hombre que se ha ido
Ri neʼ kchaknik pirqan jaay	#qum# El bebé gatea en el patio de la casa	#qum# El hombre que no tiene la mano
Kʼolik wnaq qal chik knaʼtaj ri kbʼanbʼaal chke	#qum# Hay personas que ya no se recuerda de	#qum# El niño se ha sacado
Wu ixoq kjororik wu rtzaʼm ataq kwrik	#qum# La señora ronca mucho cuando duerme	La gente se ha quedado en la casa
Ri rxaq juuj xaq qiʼn nakʼlook	#qum# La hoja de papel esta medio pegado	La casa de la madre de la mujer
Ri wnaq ataq kʼolik jun chʼoʼj chkxoʼl ketzlaj kiibʼ	#qum# La gente cando existe entre ellos un problema se desprecian	#qum# El hombre que se puso en el
Ri tʼiqbʼal kchuknik chu rnukʼik ri qʼaaqʼ	#qum# El encendedor sirve para juntar el	#qum# El hombre se ha ido
Ataq kmo lik ri knaqʼ kʼolik rkʼolbʼaal waʼchiʼ kyoʼqqaj wiʼ	#qum# Cuando se junta	La mujer se ha hecho el mal por el que se ha hecho
Ri waʼchiʼ kʼo ri wchoch mqʼen jyubʼ	#qum# Donde yo vivo es tierra caliente	El niño se ha ido
Ataq kojsaqrik ri tzeek koqʼik	#qum# C uando amanecemos el gallo canta	# #qum# La mujer se ha quedado
Njeel ri teem isetsik	#qum# Todas las bancas son redondas	# El hombre que se ha hecho el hombre
Ataq kjachʼik ri jal xaq xeew ri rqan chnooj kkanjik	#qum# Cuando se tapisca la	El hombre que se ha hecho el hombre que se ha hecho el hombre que se ha hecho el hombre
wu qʼoor kookʼ xelul pwu keʼbʼal	#qum# La masa salió fino en el molino	El hombre que se ha hecho el hombre
Tráigalo	#qum# Ri ixoq	#qum# El perro
Rwaqlaaj rjnobʼ ri tijbʼal xtzʼaqtik	#qum# La escuela cumplió el decimo sexto año de	El hombre se ha ido de la casa
Ri loʼn chʼomchʼoj rtijik	#qum# La fruta está medio ácido	# El hombre se ha echado el pelo
Ri rxjabʼ ntatanool qʼeq kkaʼybʼaal	#qum# Los zapatos de mi abuelo es de color negro	El hombre se ha hecho el trabajo de la casa
Njeel ri rxaq juuj xeʼ worik	#qum# Todas las hojas de papel se perforó	El hombre que se ha ido en la casa
Ri waakx lewlik wu rwoch	#qum# La vaca es de mejilla gorda Extendido	#qum# El hombre es el que se ha ido
Chu kxibʼxik ri chʼok kchuknik ri ixkeeqʼ	#qum# Para espantar a los zanates sirve la onda de pita	La tierra está en la tierra
Njeel ri ajkʼalobʼ xiʼ tuknik rum xibʼal kiibʼ	#qum# Todos los niños se dispersaron por el miedo	# El hombre que se ha ido a la casa
Ri achii riʼj chik sichaʼ qal kirchʼij kbʼinik	#qum# El hombre ya es viejo por eso no aguanta caminar	# El hombre se ha puesto en la silvera de la mujer
Riliil riij xtkʼutik ri kajwxik rbʼanik kukʼ ri wnaq	#qum# Es necesario mostrar lo que se quiere	# El hombre se ha ido
Ri yuʼtz kʼebʼ muul xchuknik sichaʼ kamulbʼal rbʼiʼxik pqyolbʼaal	#qum# La	Tomi la casa de la mujer
Wu leem xkʼis ri knaqʼ	#qum# La tortuguilla terminó de comer el frijol	#qum# La mujer
Wu jaws kkeʼxik chu kʼej	#qum# L a haba se muele para pinol	El hombre tiene una niña
Wu chaak kow sichaʼ qal nim xkbʼan ri ajchaak	#qum# El trabajo está duro por eso no avanzaron los trabajadores	# El hombre que se ha ido de la casa
Wu nima xbʼoʼj leʼlik wu rchiʼ	#qum# La olla grande es de boca grande	# El niño se puso en la cama
Ri nooy kiʼ qʼoxwik ri rbʼaqil	#qum# La abuela le duele su hueso	El hombre se ha dado la mano
Tkaal xkmik ri ntzʼiʼ rum riʼjaal	#qum# Mi perro se murió despacio ór la vejez	# El hombre está en la cama
Pri molbʼeem xaq kʼeebʼ ixoq xoʼpnik	#qum# En la reunión llegaron solo dos mujeres	#qum# El hombre que se ha ido
Saqsi xkojyolwik chqatziij rtqriq kʼchiʼ ri utziil	#qum# Si hablamos con la verdad	La gente no tiene nada que decir
Pri uleew kʼolik kʼiy amluʼx abʼaj	#qum# En el terreno hay montones de piedras	El hombre que no se le dio la vida
Rech qal xkojyolik, utz xttojik ri kʼaas	#qum# Para que no nos critiquen es bueno pagar la deuda	El hombre se ha ido por la casa
Ri tikʼlik yaʼ qal utz kumu kiʼ poqʼnik ri raal us	#qum# Las aguas estancadas no es bueno	T'as vu que me ha hecho el panqueque
Ri tzʼiʼ xwos	#qum# El perro es travieso	#qum# El caballo es un poco más grande
Kʼolik ri wnaq qal knmaj ri tyoox	#qum# Existen personas que no creen en las imágenes	El hombre que se ha ido a la casa
Che rajlbʼaal rkʼosbʼik r i wtziik	#qum# Que fecha nació mi hermano	# El cabrón está en la mesa
Ri nchuch yaabʼ rukʼ rqul	#qum# M i mamá está enfermo de la tos	La mujer tiene un niño
Ri ajkuun tlaʼ kʼolik rchoch waʼchiʼ rbʼiʼ oxchʼuʼk	#qum# la comadrona vive en el traingulo	# El hombre se ha hecho el pelo
Ri rchaq akʼ utz xtqajik chxeʼ ri tikaʼ	#qum# La gall inaza es bueno para abonar la siembra	#qum# El hombre que no se ha ido
Ataq kʼolik yaʼ tikʼlik xibʼal serat kiʼpoqʼnik	#qum# Cuando hay charcos de agua	La mujer se ha quedado
ajsik xokul ri elqʼoom sicha ʼ qal xnaʼ ri tzʼiʼ	#qum# El ladrón entró arriba por eso no se dio cuenta el perro	La mujer se ha quedado en la casa
Ataq xkʼosbʼik ri ajkʼaal rbʼaqʼtmaj riibʼ ri rkʼamaʼl rmuux pirqul	#qum# Cuando nacio el niño lo	#qum# La mujer se ha quedado
Ri keej bʼilbʼik wu rbʼaq rwoch	#qum# El caballo tiene los ojos grandes	#qum# El hombre se ha puesto en el
El cuarto lo han barrido	#qum# Barrendero	#qum# El hombre se ha ido
Ri nchuch utz keʼrbʼan ri xkulbʼal	#qum# Mi mamá puede hacer petate	El hombre que se ha ido a la casa
Ri pisbʼal ri juuj bʼantlik rukʼ miit	#qum# La en voltura del papel está hecho de algodón	El hombre se ha hecho con la cabeza
Njeel ri kʼyeej itzʼaplik	#qum# Todos los negocios están cerrados	El hombre está en la casa
Xsqarsxik ri riil ri achii se aclaró el delito del hombre	#qum# Dirrecion	# El hombre que se ha puesto en la casa
Chpom ri bʼeey xtukxik poqlaaj	#qum# En el camino se regó arena	# El hombre se ha ido a la casa
Ri sʼaq tʼaq	#qum# La ropa está mojada	El hombre se le dio el pelo
Ataq xsiq ri tzʼiʼ ri qan chkop xtrambʼeej rech xwiʼtaaj	#qum# Cuando el perro olió las huellas del	#qum# Cuando se le dio la mano
Ri aliit xtzaqeel wu rkaʼ	#qum# La señorita se le cayó la muela	#qum# La gente se ha ido
Ri tzʼiʼ xsok ri achii pirsmoqʼ	#qum# El perro lo hirió al hombre en la fosa poplítea	Tambo de la mano
Ri siikʼ kirbʼan kʼex chu ri tzantzqʼor	#qum# El consumo del cigarro daña el cerebro	Técnico se ha hecho el trabajo
Ataq kpetik jabʼ wu kʼotzʼaj qʼus kkaʼyxik	#qum# Frijol	#qum# La gente se ha hecho la paisana
Ataq utz bʼanmaj ri chaak qal chik ktzuntzxik	#qum# Cuando está bien hecho el trabajo no es necesario repasarlo	El hombre se ha ido de la casa
Ri ajmaak areʼ ri achi i ri xwiʼt aaj ri ixoq	#qum# El hombre que mató a la mujer es el culpable	#qum# La casa está en la que se ha ido
Ri saqkʼim kchuknik chu kbʼanik xuʼk	#qum# El pajon blanco sirve para elaborar canastas	T#T_ El niño no tiene la cabeza
Latzʼ wu rpom jaay sichaʼ qal xiʼ kʼisook njeel ri wnaq	#qum# La casa es muy reducido por eso no	#qum# El hombre que se ha hecho el hombre
Ataq kqajik ri nabʼey rqan jabʼ keʼlul ri xkawalek	#qum# Cunado cae las primeras lluvias salen	# El hombre que se ha ido
Ri xbʼaj kirbʼan kʼex chu ri qsosobʼ	#qum# El aguardiente causa daños a nuestro hígado	T'as vu que te vas a la casa
Xeʼ taq ri abʼaj kiʼkʼobʼik ri kmatz	#qum# Debajo de las piedras están las culebras	#qum# El hombre que se ha ido
Ri tikaʼ kkʼiyik rum ri rmeqʼnal ri qʼiij	#qum# La siembra crece con el calor del sol	# El hombre que se ha hecho el hombre que se ha ido
Waqiibʼ iikʼ chi k xtqajik raal wu wakx	#qum# Entre seis meses va parir la vaca	#qum# La gente se ha quedado
Jun mlol ylooj xb ʼiʼnik re waʼ	#qum# Esto lo dijo un chismoso	El hombre se le dio la vida a la mujer
Ri albʼatz xyoʼqook chu rqirxik ri rwoch ixiim	#qum# La nuera se le puso a	Comodidad de la gente
Pirwiʼ ri jyubʼ xeʼqbʼnaʼ ri chʼabʼal maaya	#qum# En la cima del cerro fuimos hacer la ceremonia maya	#qum# El árbol de la casa está en la casa
R i alaabʼ xtochʼ ri rqan rukʼ ri tochʼbʼal	#qum# El muchacho se cortó el pie con el machete	El niño no se ha ido a la casa
Ri elqʼoom chaqʼabʼ xkelqʼaaj ri rwaakx wjow	#qum# Los ladrones de noche robaron la vaca de mi papá	# El hombre que se puso en la casa
Ri nanyoox xaq kyabʼabʼ ik rum wu re tzaʼm	#qum# la señora siempre padece del catarro	El hombre se ha hecho el trabajo
Najeʼl xbʼan ri wtziik ri rchoch	#qum# Mi hermano construyó su casa retirado a la mia	# Cuando se ha hecho el trabajo de la mujer
Ri aliit nmaq wu riim	#qum# La señorita tiene los pechos grandes	#qum# El hombre se ha ido
Ri rbʼuch akʼ xnojik rukʼ rwoch ixiim	#qum# El buche de la gallina se llenó con granos de maíz	La mujer se quedó con la madre
Pri ntinmit qal kʼiy moos ikʼolik	#qum# En mi pueblo hay pocos ladinos	El hombre se ha ido a la casa
Ri tzʼuum xchiqik chu qʼiij	#qum# El cuero se secó en el sol	# El niño se ha ido a la casa
Ri ajkʼaal yaabʼ sichaʼ qal ktzeʼnik	#qum# El niño está enfermo por eso no puede reir	Mi niña se ha hecho
Wu us qal utz laj chkop kir chʼulchʼaʼ ri che ri qtij	#qum# La mosca es un animal malo porque contamina lo	El hombre que no tiene nada que se le ve
Ataq kiʼ waʼljik ri ajkʼalobʼ konjeel keʼ bʼixnik	#qum# Cuando los niños se levantan todos cantan	El hombre que se ha hecho
Chke ri ajkʼalobʼ riliil rij xkeʼtijxik rech xkeʼqʼajlaʼnik	#qum# A los niños es necesario enseñarles a saludar	El hombre tiene una mujer que no se puede
Ri ajtzʼibʼnel xeʼrtzʼibʼaaj kʼiy q taʼ pqyolbʼaal	#qum# El escritor escribió varios cuentos en el	Caular de la casa de la mujer
Ri ixoq xtzʼonjok jrubʼ rjil wu akʼ	#qum# La señora preguntó cuanto vale la gallina	El hombre se ha echado la mano
wu klobʼ xyuqpjik ataq xchnaʼnik	#qum# El lazo se estiro porque se mojó	#qum# El hombre se ha ido
La laga rtija sale cuando hay sol	#qum# Sapo	# El hombre que se ha perdido la vida
Ri xaʼk chqiʼj chik	#qum# El trozo ya está seco	# El hombre no tiene el pelo
Ri xenxipr utz chi kunbʼal ri qulaj	#qum# Para curar la tos es bueno el jengibre	#qum# El niño se desfende de la tierra
Ri klobʼ ktumxik rukʼ xweelx	#qum# El laso lo hacen torcer con malacates	La casa de la madre
Ri ryaʼl tzmeʼy utz xtqum jun ixoq rech q al ri raal xtokʼwik	#qum# El agua de la	El hombre se ha ido a la casa para
Ri qʼabʼreel pakʼlik xkanjik ataq xtzaqik	#qum# El borracho cuando cayó quedó de boca arriba	Comparador de la casa de la mujer
Ri achii ataq xbʼeek chu rkʼamik siʼ qal xkʼambʼik ri rptem	#qum# El hombre cuando se fue a traer leña no llevó su mecapal	El hombre se ha ido de la casa de la mujer
Junbʼer xkʼuqbʼsxik ri rwiʼ rqʼabʼ tinmit	#qum# El año pasado se fundó el caserío	La gente tiene que tener la cabeza
Njeel jnobʼ kbʼanik ri nimaqʼʼij	#qum# Rech ri tinmit	# El hombre que se le dio la vida se le dio la vida
Ri ixoq xpe saqtqoj chriij	#qum# A la mujer le dió vahído	#qum# El hombre es un hombre que se ha puesto
Ri alaabʼ xtzaqik xqʼoch wu rqʼabʼ	#qum# El muchacho se cayó y se quebró la mano	#qum# El hombre que se ha ido a la casa
Ri wtziik xaq xchʼutij ri rchoch	#qum# Mi hermano apuntaló su casa	#qum# La mujer se va
Chqʼayaʼpon ri yaʼ kʼolik rchoch ri Leʼn	#qum# al otro lado del rio está la casa de Elena	La gente que se ha ido
wu ekʼaʼ kchuknik chu wiqbʼal	#qum# La cola de gallo sirve para adornar	#qum# El hombre que se ha puesto en el
Iwir xintzaqken ri qʼaxbʼal chaʼnbʼal ayer perdí el teléfono	#qum# Dolor	El hombre que no se ha hecho nada
Ri wkaan kʼolik kʼeebʼ rmyaʼlbʼaal	#qum# Mi tío tiene dos hijastras	El hombre que no ha ido a la casa no ha ido a la casa
Ri saqʼuul xaq tqʼaaj kiryaʼ wiʼ, El plátano solo se da en la costa	#qum# Palo blanco	El hombre que se ha ido a la casa
Iwir xqʼeq xojkʼobʼik pjun molbʼeem	#qum# Ayer en la tarde estuvimos en una reunión	# El hombre que se ha hecho el hombre
Ri ajkʼaal riliil rij kyuqxik chu ri rqʼabʼ	#qum# El niño se debe agarrar de la mano	#qum# El hombre se ha echado
Ri ajtiij xkʼuqbʼaʼ ri tatanool chu teem	#qum# El maestro lo mando a serntar al abuelo en la silla	La gente se ha hecho el trabajo
Qonjeel qqum qʼoor	#qum# Todos tomamos atol	#qum# El niño se le pone el pelo
A qué hora nos vamos al entierro	#qum# Dentro de un año	#qum# El hombre que se ha ido
Wu loʼn nmaq kkaʼyxik	#qum# Las frutas se ven grandes	El hombre que se ha ido a la casa
Ri kuch xibʼal squkʼ chriij	#qum# El cerdo tiene mucho piojo	# El hombre se ha ido en la cama
Ri lochʼ qal xchʼij ri qʼaaqʼ xelul chriij	#qum# El bebé no aguantó la fiebre	#qum# El hombre que se ha hecho el hombre
Ri aliit ataq kbʼeek pchʼiichʼ kiryaʼ xaʼw chre	#qum# la señorita cuando viaja en carro le da vómito	#qum# La mujer se ha ido a la casa de la mujer
Ri winaq keʼchʼoʼ jnik chrij ri yaʼ	#qum# La gente pelean por el agua	El hombre se ha ido a la casa
Ri wjow njeel qʼiij qal jamlik	#qum# Mi papá todos los días se mantiene ocupado	El pueblo de la ciudad de la ciudad de la
Chu wu jaay rech chʼabʼal kʼolik kʼeebʼ mulmik uleew	#qum# En frente la iglesia	#qum# El hombre se ha ido
Ri cheʼ qʼeʼlik xk anjik pri bʼeey	#qum# el árbol quedó atravesado en el camino	#qum# El hombre se ha ido
Ri chiij qʼeqqʼoj rkaʼybʼaal	#qum# El color de la oveja es medio negro	La casa de la gente se ha ido
Riliil riij ataq xtqum ri yaʼ nabʼeey xtrqowsxik	#qum# Es necesario cuando tomamos el agua	Mi niña se ha quedado en la casa
Ri rwoch tikaʼ kkiʼyrik rum wu rtun qʼiij	#qum# La fruta se endulza con los rayos del sol	#qum# El animal se ha hecho
Ri rwoch nuxtaʼ xibʼal rkʼixil	#qum# La fruta del nopal tiene mucha espina	#qum# El hombre se ha hecho
Ri aliit kiryqʼuj ri ajkʼaal	#qum# La señorita c uida al bebé	El hombre que no tiene el pelo
Chpom ri yaʼ piʼlik xibʼal xaʼn	#qum# En el agua encharcada hay mucho zancudo	La casa de la mujer se ha ido
Ri tzʼiʼ ktzʼuʼynjik ataq kirkaʼyij wu rxoqʼjowil	#qum# El perro ronronea cuando mira su	El hombre se va a la casa de la mujer
Ataq xojopnik jaqlik chik ri rchiʼ jaay jroq koʼkik elqʼoom	#qum# Cuando llegamos ya estaba abierto la	Nu se levanta el pelo cuando se sale
Ri ajkʼaal xyabʼrik rukʼ xjir	#qum# El niño se enfermo de dearrea	El niño se ha sacado
Ri snik ktij ri rxiʼl leej	#qum# Las hormigas comen la migaja de tortilla	# El niño se ha ido
Ri kiʼ wiqnik ri nima qʼiij areʼ ri qʼus laj taq ixoq	#qum# Los que engalanan la fiesta son las bellas mujeres	#qum# Cuando se ha ido la cama
Ri traas spoqʼpoj rtijik	#qum# El durazno está desabrido	El niño se quedó en la cama
Ri wiqabʼaaq kchuknik chu ri qʼajaʼ	#qum# La sábila es bueno para las quebraduras	#qum# El hombre que se ha hecho
Ri ajkʼa al qal chik xtuʼnik rum wu xsopjik wu rqul	#qum# El bebé ya no pudo mamar porque se le	#qum# El hombre se ha hecho
Qonjeel wu ojkʼolik chu rwoch paxil nkareʼ xaq jnum ri qbʼanbʼaal	#qum# Todos los	# El hombre se ha echado por el hombre se ha echado por el hombre
Ri alaabʼ xwiʼtaj jun kuuk rukʼ ri r chʼaabʼ	#qum# El m uchacho mató una ardilla con su onda	
Ri rchʼeek wtziik xqʼajik ataq xtzaquul jun xaʼk chriij	#qum# La rodilla de mi hermano se quebró cuando le cayó un trozo encima	# El hombre que se le dio la vida
Ri wurbʼal kchʼajchʼtik	#qum# El dor mitorio es limpio	Cuzá que no se ha ido
Ri chʼiichʼ suukʼ xbʼeek pswon	#qum# El carro se fue directo al barranco	Mijo se ha ido
chpom ri uleew kʼiy kʼulbʼat ikʼolik	#qum# En el terreno hay varios muros	# La mujer de la mujer se ha ido
Jumul xtbʼiʼxik ke ri qatz riliil riij areʼ ri nimneem	#qum# Una vez se dice que lo más importante es el respeto	#qum# Cuando se ha hecho el tiro se ha ido
Ri ryaʼl iik tzeytzoj xelik	#qum# El caldo salió medio salado	El hombre que se ha ido a la casa
Ataq kojbʼinik nim tʼuus keʼlik ri qqan	#qum# Cuando caminamos mucho los pies nos	La gente se ha ido de la casa
Ataq xinsol ri kʼaam xinbʼotzʼ chrij jun piʼq	#qum# Cuando desaté la pita es fácil arrollar en un olote	El hombre que se ha ido
Xibʼal rkʼixil ri yeel	#qum# El chichicaste tiene mucha espina	#qum# El hombre se ha puesto en la cama
Pri nimaqʼiij xeʼchuknik kʼeebʼ ulanel	#qum# Para la fiesta trabajaron dos recepcionista	El hombre tiene una hija que se ha hecho
Chke xyoʼqik njeel ri poq chi rbʼanik ri nimaqʼiij	#qum# A ellos les dieron el dinero para hacer la fiesta	# El hombre que se ha puesto en el suelo
Ri wkaaqʼ areʼ jun utz laj achii	#qum# Mi sobrino es un buen hombre	## El hombre se ha hecho un buen trabajo
Ri tzʼuu m likʼmaj rwoch chu uleew	#qum# El cuero estaá extendido en el suelo	El hombre que se ha ido
Rum wu qal tzʼqaat ri rpajbʼaal ri ajkʼeynel sichaʼ xbʼeek pcheʼ	#qum# Por estar	#qum# El hombre se ha hecho
Ri qʼoor qal xqumik kʼten xtewrsxik tekʼchi xjachik	#qum# El atol no se pudo tomar	#qum# El hombre que se ha hecho
Ri wakx jurjik ri raaqʼ La vaca tiene la lengua larga	#qum# Temascal	Cuando se hace el trabajo se hace la
Qal utz xtqyaʼ jun che chqoom ri wnaq kʼa krechbʼeej	#qum# No es bueno prestar algo a alguien porque se adueña	La gente se lo hace cuando se levanta el pelo
Ri tzʼuum ri kʼaʼn chu ri kʼuqulbʼal mixjarik	#qum# El cuero que tiene el sentadero se	# El niño no tiene que tener que hacer el trabajo
Ri achii ataq kir bʼan ri awaʼn kertaqiij ajchaak chu rtoxik	#qum# El hombre cuando siembra busca	# La mujer se ha ido de la casa
Xkmik ri tʼuq laj akʼ	#qum# La gallina clueca se mur ió	El niño no se ve la casa
Ri nchuch xloqʼ jun suʼbʼal qʼabʼ	#qum# Mi mamá compró una servilleta	El niño se ha ido de la casa
Utz xtqsipaj ri poq nuʼj chke ri mebʼaʼ	#qum# es bueno regalar dinero pero a los huérfanos	# El hombre que no se puso en la casa
Ri wchoch rex ri rkaʼybʼaal	#qum# Mi casa es de color v erde	La mujer que se ha ido
Ataq kʼolik muuj chukaaj retal kʼchiʼ kpetik jabʼ	#qum# cuando hay nube en el cielo es seña que	El hombre se ha hecho el hombre que se ha ido
Ri raal kuch xiʼ qajik tiʼt njeel	#qum# Las crías de la marrana que cayero son hembras	El hombre que se ha hecho el tiro
Ri nchuch xproj ri rtkuʼl	#qum# mi mamá lo quemó su paleta	El hombre ha sido herido por la casa
Ri rtibʼliil woy chetzʼini k rtijik	#qum# La comida es bien ssabrosa	#qum# El hombre se ha ido a la
Ataq xojelpoon chu ri ilbʼal qʼus rkaʼyxik ri tinmit	#qum# Cuando salimos al mirador el pueblo se mira bello	El niño se ha hecho el pelo
Wu chʼmaay utz xtktij ri ajkʼlobʼ rech xtkʼobʼik kchoqʼaabʼ	#qum# El guisquil es bueno que	# El hombre se ha hecho con la mano
Ataq xkmol kiibʼ ri aloʼm xkbʼanken jun etzlaal chu ri qtikaʼ	#qum# Cuando se reunieron los	## Los niños se desganaron cuando se fueron a la
Ri wxqʼajlobʼ tarnuul chwij mi compañero viene atrás	#qum# Escuela	# El hombre no se ha hecho el caso de la mujer
Ri ixoq kirjokʼ ri skiil chu kaʼ	#qum# La mujer muele la pepita de ayote en la piedra de moler	El hombre que se ha ido a la casa
Wu musmut utz chi qʼxom kʼuʼxaj	#qum# El ajenjo es bueno para el dolor de estómago	# La casa de la madre está en la tierra
Ri n tatanool nim ri retambʼal	#qum# Mi abuel o posee grandes conocimientos	#qum# El hombre no tiene el pelo
Don Jesus se puso la camisa al revés	#qum# Escama	El hombre que se ha ido de la casa
Ri toch ʼaʼ kirtij ri rwoch nuxtaʼ el jilguero c ome la fruta de la tuna	#qum# Pagar	# El hombre que no se ha ido a la casa
Ri cheʼ pujpik sichaʼ kiryaʼ muʼj	#qum# el árbol es frondoso y da buena sombra	#qum# El niño se ha ido
ataq xinbʼan ri wchoch xinbʼan jun jloom	#qum# Cuando construí mi casa tuve que hacer un préstamo	# El hombre que se ha hecho
Ri saqtbʼiin jurjik wu rjey	#qum# La comadreja tiene la cola larga	El pueblo de la ciudad de la ciudad de la ciudad de la
Kʼa xaq et rchim wu chʼiichʼ xichaʼ qal xchʼij xelbʼik chu wu rujyubʼ	#qum# Por mucha carga el carro no aguantó salir en la subida	# Cuando se desprende la casa se
Ri rchak ri ixoq kirbʼan njeel qʼiij areʼ ri tʼisneem	#qum# El trabajo que hace la mujer todos los	El hombre que se ha ido a la casa
Wu jiiqʼ kiryaʼ che ri ajkʼalobʼ	#qum# La tosferina le da a los niños	El hombre se ha hecho una gran cosa
Ri aliit qʼus rkaʼyxik kukʼ ri ruwaj	#qum# La señorita se ve elegante con sus collares	El hombre se ha ido de la casa
Ataq xkʼisik ri molbʼeem ri aloʼm xiʼ tikrook chu ktzʼulxik ri altom	#qum# Cuando terminó la	El niño no se ha puesto en la cama cuando se ha hecho el
Wu chʼikaʼx xuqkee kchuknik chi siʼ	#qum# La chicharra de pino tambien se usa	El hombre que se ha sacudido
En el techo de la casa hay dos agujeros	#qum# Semana	El hombre que no tiene nada se va a
Ri chaak xaq che rbʼ anik sic haʼ xqtzuntzaj	#qum# El trabajo quedó mal hecho por eso se	El niño se puso en la cama
Aqʼabʼ xelbʼik ri achii chi rawxik ri chnooj	#qum# El hombre salió temprano a sembrar la	# El hombre se ha ido a la casa
Xibʼal xibʼaliibʼ chu ri wiʼtnel	#qum# Hay mucho miedo al asesino Ciprés	#qum# El hombre se ha hecho el
X kʼatik ri rtzʼumil rqʼabʼ ri ixoq	#qum# a la señora se le quemó la piel de la mano	Com la que se le ocurre
Jrubʼ rajlaal ri poq xeʼloq	#qum# Cuanto ascendió la cantidad del dinero	Comodo para el niño
Qaqchee chik ri k ʼ yeej kumu xchupik ri rxoqʼjowil	#qum# Ya no hay venta porque se murió el dueño Bellota de arboles	El hombre que se fue a la casa
Ri ixoq xbʼeek chi rtaqxik qʼaʼtzuy praal cheʼ	#qum# La mujer fue a buscar hongo en la	#qum# La gente no sabe nada
Paqʼiij xoʼkik ri elqʼoom pjaay elqʼnel	#qum# De día ent raron los ladrones en la casa a robar	La gente no se va a la casa
Ri qbʼey xsukʼbʼik kumu xqjnumsaj ri qchoqʼaabʼ	#qum# Nuestro camino se	El hombre se ha hecho el trabajo
Ataq xtzaqik ri ajkʼaal xelul kikʼ pirtzaʼm	#qum# C uando cayó el niño le salió sangre en la nariz	El hombre que no tiene que ser
Ri wochbʼlaal areʼ jun naʼtbʼal qe	#qum# El retrato es algo que nos recuerda	El hombre que se ha ido a la casa
Ataq xi bʼal kqʼiiqʼ ri rwiʼ jaay ktzalbʼik	#qum# Cuando hay mucho aire el techo de la casa	#qum# El hombre se ha ido en el
Ri raal chiij ktuʼnsxik kumu qal xpon rqʼij	#qum# La cria de la oveja lo amamantan porque	# El hombre se ha puesto en el camino para el
Ri yaak xeʼrtij ri raa l akʼ	#qum# El gato de monte se comió todos los pollitos	#qum# El niño se fue a la casa
Ri rkʼoʼxiil ubʼooy kchuknik chu awbʼal	#qum# La	# El hombre que se ha ido a la casa
Ri aliit qal kirkʼut saqsi tzʼeebʼ	#qum# A la muchach a no se le nota que es tartamuda	#qum# La casa está en la tierra
Ri achii xrubʼaaj ri musaat rukʼ ri ubʼ al	#qum# El hombre mató el venado con su	#qum# El hombre que se ha hecho
Ri rchiʼ jaay xpaqʼtjik rum ri rkabʼ rqan	#qum# la puerta de la casa se partió por el temblor	El niño se quedó en la casa de la niña
Ri wnobʼ yuux ri raal	#qum# Mi hernana tiene gemelos	Tonto leche
Ri tzʼiʼ xelul qʼaaqʼ chriij	#qum# Al perro le dio fiebre	Le mandaron a la mujer que se le puso
Ri tatyoox qal chik kirchʼij rjoʼxik ri rsomchiʼ	#qum# El anciano ya no aguanta afeitarse	#qum# El niño se ha ido
Njeel ri ajchaak xeʼyoʼqook chu rpaqʼik ri uleew	#qum# Todos los trabajadores les pusieron a	La gente se ha ido a la casa de los niños
Njeel ri ajchaak xeʼtobʼik chu rmolik ri abʼaj	#qum# T odos los trabajadores ayudaron para juntar la	El hombre se ha ido a la casa
Wu ulee w naʼl xtzʼaqik	#qum# La tierra se tiene que compactar bien	# El hombre tiene que tener el pelo
Ri wix kir qchʼuj ri paan	#qum# El gato le dió un mordisco al pan	# El hombre que se ha ido a la casa
Ataq xojelbʼik qonjeel x qtzʼap ijken ri rchiʼ jaay	#qum# Cerrado	#qum# El hombre se ha hecho
Ri rchʼmeʼy ntatanool xq ʼajik	#qum# El bastó n de mi abuelo se quebró	#qum# El hombre se ha hecho
Ri abʼaʼ bʼantlik rukʼ saqkiiy	#qum# La hamaca está hecha de pita de mecate	La mujer que se ha hecho
¿Cuánto cuesta el sombrero que compró mi mamá en la plaza	#qum# ¿cuándo?	El hombre que se ha ido a la casa
R i achii xelbʼik rukʼ ri rtzʼiʼ chu rtaqxik ri musaat	#qum# El hombre salió con su perro a cazar	Camarada de la mujer
Ri chʼooy xchʼulchʼaʼ ri ixiim	#qum# El ratón ensuscio todo el maíz fracción/ pedazo	#qum# El hombre que se le dio la mano
Njeel ri wnaq nim ri knoʼj sichaʼ utz ikʼolik	#qum# Toda la gente tienen buena ineligencia por eso están bien	El hombre que se ha ido
Ri nchuch xtzaltzaj ri poʼt ri xloqʼ kumu nuchʼ xkanaj chriij	#qum# Mi mamá tuvo que	#qum# El hombre se ha hecho el hombre
Ri keqʼ kiryaʼ ptaq ri rqan swon	#qum# La Guayaba se da en los barrancos	El hombre se puso en la casa de la mujer
Ri kuch xkchʼulchʼaʼ ri kwoy	#qum# Los c erdos ensuciaron la comida	#qum# El hombre que se ha ido
Cuando oímos el río tumbar rápido corrimos	#qum# Bejuquillo	El pueblo de la gente tiene que ser
Ajwiʼ xtpetik jabʼ rukʼ saqbʼuch	#qum# Hoy va llover con granizo	# La mujer se ha puesto en el agua
Ri tzʼiʼ xkbʼalktij kiibʼ rukʼ ri sjiʼl	#qum# El perro se revolcaron con el coyote	#qum# El hombre que se ha ido
Riliil riij ataq xkojwaʼljik xkojtyoxnik chu Ajaw	#qum# Es necesario cuando amanecemos debemos agradecer a Dios	talo por el niño que se le dio la mano
Kqʼoxwik ri nxkin	#qum# Me duele el oído	#qum# La tierra se ha hecho
Ri ntzʼiʼ naqʼtlik kirtij iik	#qum# Mi perro está acostumbrado comer chile	La gente se ha ido a la casa
Ptaq ri rqan swon kiryaʼ xibʼal ri chibʼaʼ	#qum# En los barrancos se da mucho el helecho	#qum# El hombre que no se ha ido
R i ajtʼisnel xwiʼtxik kum ri elqʼoom	#qum# El sastre fue matado por los ladrones	# La gente se ha ido a la casa
Ri ajtiij xbʼ iij chke ri ajtijnel kʼotz kixkʼ olaq	#qum# El maestro dice a los estudiantes que guarden	# El hombre que se ha puesto en la casa
Ataq xeʼriqtjaq ri ixoq juplik bʼanmajken chre	#qum# Cuando le fueron a encontrar a la mujer la	#qum# El hombre que se
La orina apesta mucho cuando hay mucho calor	#qum# Camarón	El niño se siente
Nim ri kaʼy kbʼanik chu ri waʼktbʼal	#qum# Mucha diversión se hizo en el parque	El niño se ha puesto en la cama
Ri yaaj utz xttijxik chke ri ajkʼlobʼ	#qum# El regaño es bueno enseñarles a los niños	# Cuando se hace el trabajo
Wu kuuk xkʼis ri a j chtijik	#qum# La ardilla se terminó de comer los elotes	# El hombre que se ha ido
